Title	Description
수학이 좋아요	"... 공식을 알아두면은 평생 써먹을 수 있죠. 무척 효율적입니다. 이러한 효율성, 명쾌함, 딱 떨어지는 해답이 존재한다. 이런 점들이 수학의 매력이고 그 매력에 끌리면은 수학을 좋아하게 되는 것입니다. "
수학 좋아요	수학 좋아요  수학은 어려운 문제를 풀었는데 정답이면 그 쾌감이 좋긴 하죠~ 그래도 수학은 개념을 확실하게 잡아야 하는 과목 이니까 천천히 이해를 해가며 학습을 하시면 좋습니다
수학이 좋아요	수학이 좋은데 문제가머냐면 수학을 좋아하는거때문에 다른과목이 너무 재미가없어졌어요 어떡하죠 흑흑 진짜로 하..ㅠㅠ 국어 한국사 이런과목들이 너무 싫어요 에휴  수학은 수리 논리를 물어보고 언어(국어)는 언어 논리를 물어보죠.... 
중1 영어공부...수능식으로...수학영어 다있으면 좋아요... 	... 영어는 빅3 못들어 갈 실력인 거 같으면 해빛나인이나 조금 이르겐 kns 초등관 도 나쁘지 않은 선택인 듯 합니다. 대치최선이나 함영원 선경도 내신으로 유명해요 중1까진 뭐 깊은생각 파인만 다원교육 수학의 힘 미래탐구 다 좋아요....
일산 후곡 수학학원 어디가 좋아요'?	이제 고등학교 올라가는 예비고1 입니다 후곡수학학원... 고등학교 수학 내신 잘 볼 수 있도록 잘 가르쳐주는... 이전 수학학원 다니면서 많이 힘들었는데 진짜 끝까지 잘... 저 공부 정말 잘하고 싶어요 ㅠㅠㅠㅠ 일산후곡수학학원... 
우공비 수학 좋아요??	"우공비 수학 좋아요?? 아 그리고 우공비 수학 과정이 뭐뭐 있나요?? 개념원리가 좋구요... 수학의정석,개념원리 추천합니다. "
입시미술하려는데 수학이 좋아요	... 그 한 분야에 모든 걸 투자해서 하는 경우가 대다수니까요 근데 수학이 재밌으면 하는거죠 시간낭비를 해서라도요 사람들이 게임 시간낭비라고 안하나요 다 하죠 현실이고 뭐고 본인이 좋아하는 길을 따라서 가는 게 좋다고 생각합니다 
남양주 기숙학원에 수학 좋아요??	... 수학이 조금은 약해요. 그래서 남양주 기숙학원을 알아보는 첫번째로 수학질문 잘받아주는 학원을 찾아요. 이관데 기초는 되는거 같은데....수학이 잘 안되요ㅜ 남양주... 남양주 기숙학원에 수학 쌤 추천해주세요. 그리고 그 학원에서... 
폴수학! 좋아요?	고2구요 문과생이에요 수학을 못하는데요 개념이없고 단순계산도 잘 틀리고 내신이랑 모의고사 둘 다 성적안좋아요 과외를 하고있는데 워낙 공통수학 부분도 못하니까 좀 힘들거든요 숙제할때도 단순개념에서 막히고.. 수학포기할까... 
개념 잡기로 체크체크 수학 좋아요??	... 어려운 문제가 나오면 시도도 하지 않는 편이라 개념이라도 잘 잡아야 할 것 같아요 ㅜㅜ 수학에 대한 자신감도... 체크체크 수학 문제집을 이용하면 개념과 반복 학습으로 기본기를 잘 잡을 수 있습니다. 교재는 진도 교재와 개념... 
영어가 좋아요 아니면 수학이 좋아요?	영어가 좋아요 아니면 수학이 좋아요?  두개중에 고르라면 수학이 나아요
수학의 정석 좋아요?	수학의 정석 좋아요?  개념공부 하기는 좋습니다.
구미동 성적안좋아 수학과외 영어과외 구해봅니다	"구미동입니다 성적 안좋아서 수,영 두과목 해보고싶은데 좋은 샘 만나려면 구미동영어과외 구미동수학과외 잘 구하는 방법좀 알려주세요! 구미동과외 정보 어디서 구해요? 안녕하세요? 구미동과외 문의주셔서 답변드릴게요! 학생과의... "
안녕하세요 수학좋아님	"안녕하세요 방금 만났던 사람인데요 수학을 좋아하신다고 하셔서 친추하고 질문드립니다 미적분 좋아하세요? 소개 보니 초등학생이셔서 깜짝 놀랐어요. 저는 수학 전공자입니다. ^^ 초, 중등 수학교육 관련 공부하고 있어요. 수학을... "
쎈수학이 좋아요 개념원리RPM이 좋아	문제유형을 빨리 정확히 이해하하려면 쎈수학이 좋아요 개념원리RPM이 좋아요? 개념원리 RPM을 하셔야죠 개념원리부터 알아야지 문제유형을 빨리 정확히 이해가 됩니다. 
수학이 싫은데 수학이 좋아요	교과과정에서 배우는 수학은 너무 싫고 힘든데 수학자들이 주장하는 수학은 좋아요. 교과과정 수학도 수학자들의 주장을 배우는 거긴한데.. 음 이게 무슨 말이냐면 시간내에 정해진 방식으로 문제를 푸는 것도 싫고 그냥 교과서에 함수란... 
수학이 좋아여 과학이 좋아여	수학이 좋아여? 과학이 좋아여? 과학은 수학과 관련되있지만 전 개인적으로 수학을 더 좋아합니다 수학은 과학의 여왕이라하거든요 ㅎㅎ 글고 수학은 계산같은 연산이 재밌고 과학은 나름대로의 개성을 살려서 하시면... 
기화펜 좋아요?? 수학 풀때 노트에	기화펜 좋아요?? 수학 풀때 노트에 풀고 문제집엔 답만 쓰고 채점만 하는데 여러번 풀려니까 지우는것도 까다롭고 수정테이프도 너무 많이들고 그래서 기화펜 써볼려고 하는데 기화펜 괜찮나요?? 생각보다 빨리사라져서... 
수학 잘하면 뭐가 좋아요??	"수학 잘하면 뭐가 좋아요?? 수학을 잘하면 과학에도 도움이 되고 학자가 되고싶으시면 수학자, 수학자 교수, 수학 선생님 이공계는 실생활에 쓰일려면 공과대학으로 진학하시면 많이 쓰입니다. 설계할 떄 수학을 쓰기도하고 통계로 낼 때... "
호매실 수학학원 어디가 좋아요?	... 큰애가 혼공만 하다가 고1첫중간고사후에 결과가 안좋아서 넋이 나가있었어요ㅜㅜ 엊그제는 처음으로 저한테 수학학원을 보내달라고하네요 학원은 알아본적도없고 계속 혼자 잘해왔었는데 고등학생들은 학원을 많이다니나요? 어디서... 
두정동 보습학원 찾아요~ 초중등 영어 수학 공부방 좋아... 	... 두정동수학공부방 추천해주셔도 됩니다 ~~~ 영수... 두정동수학학원 을 찾고 계신 것 같아서 답변드려요^^ 많은... 두정동영수학원 수업을 진행하기 때문에 더욱더 일대일로... 두정동국영수학원 에서는 자기주도적인 공부를 위한... 
파주 금촌 종합학원으로 영어 수학 어디가 좋아요?... 	... 금촌 영어 수학 공부방도 좋아요. 안녕하세요 지금 금촌에서 수학학원과 영어학원을찾아주시는것같아 제가 한말씀 드려보도록 하겠습니다 우선 공부를 하기 전 질문자님께서 말씀해주셨던것처럼 자존감 즉 자신감이 기본적으로... 
수학이 너무 좋아요	... 수학이 넘무 좋아요 ㅠㅠㅠㅠㅠㅠ 수학 문제를 푸는 그 과정 하나하나가 너무 즐겁고 새롭고 각 문제집들 모두 다른 유형의 문제들을 담고 있어서 너무 새롭고 신선하고 문제를 푼다는 행위 자체가 전 진짜 미친 것 처럼 좋아요... 
용인수지 수학학원 어디가 좋아요?	"아이가 고1인데 수학학원좀 옮기려구요 공부를 워낙 안하는애라 믿고 맡길만한... 용인 수지 소규모 정예, 영어학원 및 수학학원 (영수학원) 교육팀장입니다.... 수지수학학원 수지초등수학학원 수지중등수학학원 수지고등수학학원... "
수학 개념문제집 뭐가 좋아요?	"개념원리랑 수학의정석중에 뭐가 좋아요? 더 좋은거 있으면 추천해주세여  수학 개념서로는 개념원리, 라이트쎈 많이 사용합니다. 그리고 문제 풀이 용으로는 알피엠이랑 쎈, 자이스토리, 마플 많이들 사용하구요. 그 다음 일품이나... "
수학여행경주로가면좋아요?	"수학여행경주로가면좋아요?  네~ 좋습니다. 저도 학생 때 경주로 수학여행 많이 갔었습니다. 경주에서 가볼 만한 곳들도 알려드리겠습니다. 첨성대, 동궁과 월지, 대릉원, 보문관광단지... "
중3 중곡동 수학과외 좋아요??	중3 남중딩인데요 중곡동수학과외 괜찮아요??? 수학과외 하고싶은데 좋은가... 저 수학 잘해요 반에서 3등 안에 들어요 안녕하세요 믿음쌤전문과외 입니다... 중곡동수학과외 를 많이 알아보고 계십니다! 중곡동수학과외 를... 
수학학원 어디가 좋아요?	"수학학원 어디가좋아요? 고등부까지 관리 잘해주는 성적도책임져주는 학원추천해주세요  안녕하세요~^^ 수학학원을 생각하고 계시네요. 저는 고등부, 성적 관리를 원하신다면 학원보다는 1대1 맞춤 과외를 추천드립니다. 1대1맞춤과외는... "
수학50점	... 수학을 좋아 하고 또 잘하고 싶은데 이번에 점수가 중학교보다 반토막이 났습니다... 이걸 어떻게 받아드리고 또 어떤식으로 해야할지 또 수학에 소질이 없는건지 잘 모르겠습니다... 1. 개념이해가 완벽하지 않은데 문제풀이에... 
중계동 수학학원 어디가 좋아요?	중계동 수학학원 보내려는데요~ 안녕하세요 중계동 수학학원 문의드립니다..... 수학을 포기하지 않았으면 하는 마음에... 학원을 보냈는데 성적도 잘 안... 중계동수학학원 찾고 계신 것 같네요! 실제로 수학은 일찍 포기하면 돌이킬 수... 
수학쌤이 좋아요	중2인데 수학쌤이 너무 좋아요  수학선생님도 이 사실을 아시면 너무 좋아하시겠어요^^ 수학선생님과의 좋은 관계 유지하면서 공부도 열심히 하면 우리 친구에게 정말 많은 도움이 되겠는걸요? 열공하세요~~~^^
"저기,, 제가 수학을 좋아 하는데요, 수학을 이용하는... "	"음,, 그러니깐, 제가 통계쪽은 싫어 하고 방정식이나 함수 같은 그런 걸 좋아 하는데 수학으로 먹고 살수 있는 직업이 있나요?? 의사 되려고 하고 있는데 의사가 그렇게 적성에 맞는지도 잘 모르겟고요,, 좀 알려 주세요^^: 의학계에... "
수학인강 어떤 쌤이 좋아요?	수학인강 어떤 쌤이 좋아요? 수학인강 어떤 쌤이 좋아요? 이번에 고2 올라가는 학생이구요 인문계열입니다. 수학인강 어떤걸로 들어야 할지 제가 인강쪽으로는 잘 몰라서요 친구들은 많이 알고 있고 추천도 해줬는데 기억도 안 나고 귀에... 
이기적 유전자 책 수학에 관련되어있나요?	"어떤 수학이라도 좋아요ㅠㅠㅠ그나마 관련되어 보이는게 이것밖에 없어서요..당장 내일이 수행평가라서요ㅠㅠ  https://youtu.be/bGEpW0wJvyc 이기적 유전자는 생명공학, 유전자 등에 더 관련있습니다. '수학이 필요한 순간... "
수학 좋아 하시는 수학천재님들 이거좀 봐주세요.	우리나라에 수학천재네티즌 님들이 상당히 많더라구요 그래서 궁금한게 생겨서 질문합니다. 보통 30 곱하기... 이거 수학천재님들이 말로 좀 설명 해주실수 없을까 해서 이렇게 질문 올려요 답은 이렇게 나오는데 머리로... 
일본노래인데 대충 내용인 수학은좋아하	일본노래인데 대충 내용인 수학은좋아하는데 국어는 싫어합니다? 이런내용인데여 공부에관한 노래? 뭐랄까 공부땜에 차별되서 그거에대한 감정이 잘 들어난노래랄까? 우타이테나 하나땅같은 우울할때듣는 그런 랩종류랄까? 노래내용은... 
수학학원 좋아요?	"안녕하세요 초6 되는 여학생입니다 혹시 수학학원 다니시는 분들께 여쭙는건데,수학학원 좋아요? 혹시 괜찮으면 학교 후배,아니면 저 친구랑 같이 다니게요 저랑 같이 다니는 친구는 피아노학원 다니다 끊었어요 엄청 싫다고..학원... "
수학 내신 등급	... 3등급도 안되요 ㅜㅜㅜ 제가 근데 수학을 좋아하고 자신있어한단말예요 근데 너무 실수를 많이하고+이번 시험 공부법이 잘못됨을 깨달음 >그래서 기말에 잘본다면 치대약대 계열 노릴 자격되나요ㅠㅠ 제가 원래부터 약대가 꿈인데... 
수학이 너무 좋아요.	... 저도 중2 여학생이고 대치동 근방에 살고 있는데ㅋㅋ 저도 수학 엄청 좋아해요~~ 요즈음 수2 끝내면서 슬슬 수학을 싫어하게 될것 같기도 하고요ㅋㅋㅋㅋ 그래도 중학교 수학은 엄청 좋아해서 애들이 저보고 미쳤냐 그래요 ㅎㄹ...... 
[예비고1] 수학의정석//개념원리 어떤게 더 좋아요?	... 사는게 좋을것같에요 정석이 어렵긴해도 한번 이해만 잘하면 개념원리 그냥다 풀리거든요 그러니까 정석으로 개념을익히고 개념원리로 개념을다지는정도? 문제는 쎈수학이 좋아요 둘중에 하나만 해야된다면 정석을 추천하고싶어요
마곡엠밸리 영어학원 수학학원 공부방같은곳도 좋아요!	"... 마곡엠밸리영어학원 마곡엠밸리수학학원 찾고 있어요 실력이 좋은곳이... 학부모님 걱정이 많으실것 같아요 신방화 마곡엠밸리에서 영어학원 수학학원... 수학, 영어, 국어 포함 전과목 수업을 진행하고 있으며 전문적인 관리와... "
수학풀때 행복해요	"일반고 4등급인데요, 수학이 좋아요. 수학 성적이 뛰어난 것도 아닌데도 안 풀리면 스트레스 받기도 하는데요 모르겠어요 그냥 수학이 좋아요. 막 문제 풀어 제끼고 그런 것보다 틀린걸 고민하고 찾아가는 과정이 너무 좋고.. 개념 배우고... "
두산 중2수학책이좋아여 디딤돌중2 수학책이좋아여?	두산 중2수학책이좋아여 디딤돌중2 수학책이좋아여? 수학교과서는 디딤돌이 내용이 알차고 깔끔하고 체계적으로 잘 되어 있더군요. 교과서는 디딤돌교과서 강추!!! 참고서는 한권만 할거면 디딤돌 개념원리 두권 할거면 디딤돌 교과서... 
수학 좋아 하시는 분들..사선식에서는 왜 볼록다각형만... 	사선식을 배운지 오래 되었는데요. 오늘 행렬문제가 나와서 풀다가 사선식 다시 보니까 볼록다각형 밖에 안된다고 하더라고요. 그런데 정석 연습문제에 나오는 오목다각형을 공식에 넣어서 풀어 보니까 답에 똑같이 나와서 저는... 
수학 문제집을 다시 살려고 하는데요...	... 쎈은 문제만 있구요 디엠은 설명이죠 따라서 디엠이랑 쎈 찰떡궁합 ㅎㅎ 개념유형은 문제가 좀작네요 ㅎ .. 구지 하자면 디엠 과 쎈 수학을 같이 쓰셧으면 .. 쎈 수학 좋아요 ㅎㅎ 문제도 많구 유형도 여러가지구 . 
원주 초등수학 어디가 좋아요? 학원이나 수학과외 쌤... 	원주 무실동인데 초등수학 어디가 제일 좋을까요? 지금 다니던 학원이 있었는데 그만두고 2주정도 쉬고 있거든요.... ㅠㅠ 원주초등수학 잘 이끌어주시는 수학과외 쌤 아시는 분이나 진짜 괜찮은 수학학원 있으면 좀 알려주세요... 
"찾아요~ 저렴한 영어,수학 공부방 도 좋아요~ 알려주세요~~"	... 공덕역영어공부방 과 공덕역수학공부방 추천해주세요~~ 안녕하세요 마포 염리동 공덕역수학학원 을 찾고 계신 것... 공덕역영수학원 수업을 진행하기 때문에 더욱더... 공덕역국영수학원 에서는 자기주도적인 공부를 위한 분위기... 
부평구 산곡동 남남수 수학학원이 그렇게 좋아요?	"... 어떻점이 좋아요?? 남남수 수학학원이 수학성적 45점맞은 학생은 98점으로, 52점짜리를 100점으로, 80점대를 90점 후반으로 올렸다고 광고하고 다니는데.... 사실인가요???? ( 이건 구라인듯-_-;;) 학원 수업방식좀 자세히 설명해주세요!!!... "
수학이좋아요국어가좋아요	"수학국어는짜증난다  사람마다 다르겠지만, 수학에는 답이 정해져있고, 국어에는 답이 정해져있지 않으니까, 어떻게 보면 수학이고, 상상하기를 좋아하는 사람에게는 국어가 좋을수있죠."
자사고 수학만 1등급 받고 대학갈수있을까요..??	... 근데 제가 수학을 좋아하기도 하고 그나마 잘하는데 수학만 3년내내 1~2등급 받고 다른건 7~9등급 받고 좋은대학 갈수 있을까요? ㅠㅠㅠ 진짜 수학이 좋아요 저희학교가 1등급이 70점 대예요 걍 한우물만 팔까요? 다르거 하다가... 
수학공부전략이랑 학습지에 대해	... 그리고 해법수학 좋아요? 제가 굵게 한 질문에 답변을 해주셔서 불쌍한 고3에게 도움을 주세요ㅠ_ㅠ 흠... 진짜 안타까운 사실이네요.. 실수로 15~19점 나가다니.... 저도 그런적 많습니다.. 실수로 12점 까지 나간적 있습니다.. 그것도... 
대치동 수학학원 어디가 좋아요?	대치동 수학학원 찾고 있습니다. 10살 되는 딸아이 유학을 보낼 계획 중에... 그렇지만 아이의 수학이 걱정이 됩니다. 우리나라 학생들 수학실력이 상당히... 그리고 유학을 가게 되면 자연스럽게 수학을 멀리할 것 같아 아이가 수학에 대해... 
수학을 잘하는게 좋아여 영어를 잘하는	수학을 잘하는게 좋아여 영어를 잘하는게 좋아여? 둘 다 잘하는 게 베스트이긴 한데 굳이 하나 택하라면 영어 ㅎㅋㅎㅋ 
특강수학 !!!!!!!!!!!!!	"특강수학 좋아요 ? 제가 중학교 올라와서부터 공부를 안 했는데... 초등학교 때부터 수학을 무지 싫어했거든요, 그래서 중학교 때부터 연을 끊었는데... 중3되니까 참 막막하더군요. 배운 게 없어서... 정말 공부 좀 할 껄 이라는 생각 밖에... "
고1 수학[내공10]	... 수학 좋아 하게 되고 잘할수 있는 조금의 힌트와 방법이라도 좀 가르쳐주세요  안녕하세요 전 현 고2 이과 재학중인 학생입니다. 제 고1때 했던걸 토대로 말씀해드리겠습니다. 1. 정석 ★★★★★ 필수이죠..개념원리하신다는데... 
"수학이랑, 물리가 좋아요// 어느 학과를 가는게 좋을까요 ?"	"... 암튼, 좋아요 - 수학같은 경우는 1학년때까지는 모의고사도 2~3개 틀리고 , 잘 했었는데 , 2학년 들어서 공부를 안했더니 , 100점만점에 60~70점대로 떨어지더군요.. 좀 충격 받았죠;; 그래서 요즘은 공부 하고 있는데 , 역시 재밋더라구요... "
중1수학잘하는법	... 진 짜로 수학 좋아하고 잘하는 사람 아니면 풀기 힘들다고 생각해요.. 저도 수학 좋아 하지도 않고 별로 잘 하지도 않거덩요... 그래서 비 상에서 나온 문제집이 얇길래 그거 샀어요^^ 근데 비상것도 문제 꽤 많고 풀이 잘 되있고... 
수학 문제집 추천	"... 틀려서 중등수학 심화 문제집을 다시 풀어보려고 생각중입니다. 에이급 수학, 일품 수학, 블랙라벨 등 생각하고 있는데 어떤 게 좋을까요 고1 3월 모의고사 4점짜리 문제 정도 난이도의 책으로 추천해주세요.  에이급 수학 좋아요!!"
수학여행경주로가면좋아요?	수학여행경주로가면좋아요?  보통 학교에서 코스짜여져 있어요 괜찮은데로 갑니다 ^^
중등 수학인강은 어디가 좋아요?	보통 주위에 보니까 엠베스트랑 온리원 둘중에 많이들하던데 어디가 수학이 더 잘하나요? 국어나 영어는 어느정도... 강의질도 좋아서 좋더라구요 학원의 경우 여러 학생들을 한명한명 케어 해주지는 못하거든요 인터넷 강의에서... 
50일 수학 노베이스한테 쓰기 좋아요?	... 50일 수학 완전 노베이스에게 쓰기 좋아요?  네. 50일 수학이 고1을 위한 중등수학 총 정리죠. 완전 노베이스가 봐도 되는 강의입니다. 50일 수학도 어려우면 30일 수학이 초등수학 총정리니까 보셔도 좋구요. 그 다음 수상 수하는 ebs에... 
중등수학 잘가르치는 쌍문동 수학과외 어디가 좋아요?	수학공부 어려워하는 아이 때문에 걱정입니다... 중2 1학기... 쌍문동중등수학과외 잘가르치는 곳 있을까요? 형이... 이 근처 쌍문동수학과외 중등 전문 쌤 알고 계시면 추천... 영어 수학 진행 지금도 하고 있는 학군이기 때문에... 
고2 수학 문제집 뭐가 좋아요?	고1때 수학 내신 3~4등급 정도 나왔는데 방학동안 한석원쌤 생각의 질서 수1... 문제기본서 쎈 고등수학 1을 추천합니다. 3000만명이 선택한 베스트셀러 쎈은... 또한 문제를 난이도별로 구분하여 체계적으로 수학 실력을 키울 수... 
수학문제집뭐가 좋아요 ? (추천)	... 근데 수학 문제집 뭐가 좋아요..? 완자나 우공비 뭐이런거 있잖아요 .. 수학 잘 못하는애들한테 좋은 문제집 좀 추천해 주세요 .! 못하시면 일단 기본을 먼저 하셔야겠네요 중3이라면 아직 늦지 않았습니다 하지만 2학기부분은... 
침산동 수학학원 영어학원 찾아요. 침산 싸용예가 2차... 	... 영어수학 같이하는 곳도 괜찮고 따로 전문학원도 좋아요. 침산동 학원 추천해주세요. 침산동 수학학원 영어학원 찾아요. 침산 싸용예가 2차 인근이면 더 좋아요 안녕하세요. 침산쌍용예가 2차 근처에 수학하원 영어학원 찾고 있어요.... 
많아요ㅠㅠ 문과보다는 과학과 수학이 좋아 이과를 선	제가 이제 #고2 에 올라가는데 직업선택에 있어서 고민이 많아요ㅠㅠ 문과보다는 과학과 수학이 좋아 이과를 선택했는데 제가 호텔리어 승무원 이런일을 하고 싶은데 이과에서도 이런쪽으로 갈수있을까요? 선택을 잘못한걸 까요.. 그리고... 
고2 정시 수학 강의추천	"고2 정시파이터 입니다 형편이 안 좋아 수학학원을 끊게되어 이제부턴 혼자 수학공부를 하려고 하는데요, 아무래도 개념이 점점 어려워질테니 강의가 필요할 것 같아서요 목표는 수능수학 1등급 맞는건데… 학원에서 알려주던 꿀팁?... "
바라보는데 김포 영어과외 수학과외 어디가 좋아요?	"... 맞는 수학진도로 복습해주고 선행나가주는 수학과외 원해요 김포수학과외 찾는 김에 이번에 김포영어과외 까지... 기본적으로 아이에게 맞는 맞춤형 과외교육에 대해 생각하시고 있으시네요!^^ 먼저, 김포수학과외 김포영어과외는... "
후곡학원가 중에 수학학원 어디가 좋아요? 잘 가르치는... 	후곡학원가 수학학원을 알아보고 있는데 친구들한테 물어보니까 프라임원을 제일 많이 다니더라고요. 차량운행도... 수학 성적이 안올라요. ㅠㅠ  안녕하세요 푸린쌤 입니다 :) 오늘 학원을 추천해드리려고 하는데요. 저희 학원은... 
메가스터디 수학 쌤 누가 좋아여	... 대충 현우진 쌤이나 강혜영 쌤 생각하구 있어요 이 쌤들 말고 다른 선생님들 있으면 추천해주세요ㅛ ㅠㅠ 메가스터디 수학 쌤 누가 좋아여 고2 강의 끊으려고 하는데 누가 잘 가르치시나요?? 대충 현우진 쌤이나 강혜영 쌤 생각하구... 
수학잘하는법ㅋ	"... 솔직 히 수학 좋아 하는 사람이 그리 많은 편은 아닙니다. ㅎ 어째든 님 이 중 3 이라고 하시는 더욱 잘 적어 드려야 겠네요 중3 시기 를 노 치면 안되요 . 노치면 끝남 고등학교가서 절대 못따라감 중 1 ,2 학년에 잘 안들었다고요... "
수학 좋아하시는 분들 ㅠㅠ 질문 있습니다.	"... 수학 좋아하시는 분들 수학 좋아 할 방법 없나요? 지금 이 글을 보시는 ........... 수학을 좋아하시는 분들 게임보다 수학이 좋나요? 수학 정말 좋아할 수 있는 방법 없을까요?  흠, 저로서는 좀 드릴 말씀이 없어요-_-;;; 저 초6인데요. 그냥... "
중3수학문제집 추천좀 해주세요	... 완자수학 괜찮냐고 물어보셨죠 완자수학 좋아요! 완자껀 설명 정말 자세하고 꼼꼼히 잘되어있어서 독학하는데는 정말 최고죠. 하지만 가격이 너무쎄죠.. 가격좀 내렸으면하는.. 그리고 정말 좋은 교재이긴한데 웬지모르게 전... 
중3수학 도와주면 좋아요!!	누구보다 빠르게 채택  ............
신사고 TheM이 좋아요? 수학의 바이블이 좋아요?... 	"... 수학문제집 신사고 TheM이 좋아요? 수학의 바이블이 좋아요? 아님 다른것을 추천해주셔두 되구요^^:; 지금 정석, 개념원리 거의다 끝내가는데요... ㅠ 정석은 정말 보면 펴자마자 휴~ 라는 생각이 듭니다.ㅎ 고등학교 책은 다 이런가... "
내공의힘-수학 좋나요?	... 내공의 힘 수학 좋아요. ㅎ. 위에서 얘기하다 딴얘기로 갔네요. 수학 제가 썼었는데 내공의힘문제에서 학교시험문제와 똑같은거 봤습니다. 심본거죠 . ㅋ 학교시험봤을때 내공의힘 문제랑 같은 문제가 있어서 한두문제는 점수 땄죠.... 
중2 수학	"중2 수학 연립방정식 활용 작년학생수, 올해학생수 구하는 문제를 응용하여 수학을 좋아하는 학생, 싫어하는 학생으로 나눠서 문제를 만드려고 하는데 어떻게 만들어야 올바른 식이 될까요..?0 <작년> 수학 좋아하는 학생 수: x 수학... "
"고1수학 공부법, 문제집"	... 이제는 수학이라면 저도 모르게 자신감이 붙게 되더라고요~~예전에는 수학하면 토나올거같은느낌이였어요ㅋㅋㅋㅋㅋ 님도 힘내세요 \ㅋㅋㅋㅋㅋ 정말 하면 됩니다.ㅋㅋㅋㅋㅋㅋ쎈수학 좋아요~~쎈수학아니면 개념+유형 유형편추천해요~~
주요과목 중 수학이 제일 낮음	제가 이과라 과학은 그 나마 성적은 좋은데 수학이 안 좋아요… 그래도 과학처럼 수학도 좋아하고 재미있는데 왜 10점대가 나오는지 원…. ㅠㅠ 대학가면 악영향 주는 거 아닐까요.. 모의고사 결과도 8등급..인데 ㅠㅠㅠ 아직 고1인데도... 
중2 온라인 강의 수학어디가 좋아요??	전과목 안하고 수학만 중2 1학기꺼 할려는데 어디가 좋아요?? 그리고 제가 지금 수학을 되게 못하니까 좀 쉽게 하거나 기초부터;;; 해주는데 있으면 좀 알려주세요 그리구 아무꺼나 더 알아야될꺼ㅡㅡ;; 있으면 알려주세요 최대한... 
[내공] 수학 학원 어디가 좋아요?	"... 수학 학원을 다니려고 합니다... 단순히 내신을 위해서 다니는 학원이 아닌, 심화된 내용과 경시대회 정도의... 단순히 학원강사로 썩기 아까운분이시거든요~ 이분한테 연락해보세요~ 미친듯이 달려들어서 물어보는학생 최고로 좋아... "
초등수학 학습지 좋아요?	"... 초등수학 학습지에 관해서 질문 주셨군요 아이의 자기주도적 학습능력을... 밀크티는 수학, 영어를 수준별 학습으로 진행하고 있는데요 간단한... 초등수학 학습지에 관해서 답변 드렸는데 도움되셨으면 좋겠네요 밀크티 초등은... "
초등수학 학습지 좋아요?	"... 초등수학 학습지에 관해서 질문 주셨군요 일을 관두고 육아에 몰입하는... 밀크티는 수학, 영어를 수준별 학습으로 진행하고 있는데요 간단한... 초등수학 학습지에 관해서 답변드렸는데 도움되셨으면 좋겠네요 밀크티 초등은... "
영어교재와 수학교재	... 왕수학이 제일 나은것 같아요 저도 그거 써봤는데요 적절히 쉬운 문제도 있고 심화 학습도 있으면서 애들 재밌으라고 쉬어가기도 단원마다 있어요 PS.참고로.... 1년뒤면 중1되겠내요????? 그러면 천재교육의 체크체크 중학수학 좋아요 
제가 수학은 안좋아하고 과학은 좋아하	제가 수학은 안좋아하고 과학은 좋아하는데 수학 공부 많이 안해도 되는 과학관련 직업이나 학과 있을까요 생명과학이나 지구과학쪽은 수학을 딱히 사용하진 않습니다. 하지만 현재 대입체계에서는 문과든 이과든 수학을 버리면 절대... 
중3 수학문제집	... ㅎ 개념원리는 중학교껀 별로예요 해법 2000제 풀어보세요 문제유형이 엄청 다양해서좋아요 기본적인거 끝낫는데 개념원리하면 절대안되죠 문제많이 풀어야되요 2000제 싫으시면 해법필수학 수프로젝트 아니면 쎈수학 좋아요... 
수학ㅇ이 너무 좋아요	"수학ㅇ이 너무 좋아요 중딩때까지 수포자로 살고 수학 극혐했었는데 요즘 수학이 너무 재밌습니다ㅠㅠ 수학과 이런데 나오면 취업 잘되나요? 수학과로만는 보통 취업을 하지는 않고, 복수전공을 합니다. 예를들면 금융전공으로 가서... "
중2수학100점맞는법	... 그래도 기초는있는상태이고 수학이 좋아요 그전엔 문제집을 쉬운걸 풀었지만 지금은 쎈풀거거든요 c단계말고 b단계만 풀건데요 선생이 이번엔 좀 어렵게 낸다고 하는데 80점이라도 가능할까요? 쎈풀거임 하루에 25문제... 
수학 인강 어디가 좋아여?	중학교 수학 인강 어디가 좋아염.?? ^-^수학 정말 .. 힘들어서 혼자는 복습도 잘 안되고.. 예습은 말도 할거없지만..^^;헤헤... 반친구들은 절반이 인강 듣던데. 음... ebs 수박씨 이렇게 많이들 듣더라구염. 어디가 괜찮져?? 전 수박씨... 
"5학년2학기수학좀가르쳐주세요,,,"	... 포인트 왕수학 3. 아하 왕수학 4. 테크노 해법수학 좋아요... 백점맞는 수학도 좋고요 백점맞는 수학은 재밌있어요. 쉽고 전과목으로 다 있으니까 좋고... 그럼 열심히 푸세요. 모르는건 성생님한테 물어보고 열심히 하는 게 제일 좋으니까
안좋아요. 영어과외 수학과외 통해서 내신 올려볼려고... 	... 내신위주로 공부를 하고 있는데 아무래도 영어과외 수학과외 통해서 내신 올려볼려 해요. 도와주세요.  안녕하하세요 부산에서 수학과외 영어과외 진행중인 과외 선생님 입니다. 과목별로 전문 선생님과 맞춤학습으로... 
수학동아리 부스추천	... 수학 퍼즐: 수학적 아이디어를 활용한 퍼즐 게임을 제작하여 방문객들에게 즐길 수 있도록 도와주는 것도 좋아요.. 3. 수학 마술: 재미있는 수학 마술을 보여주는 것도 좋은 아이디어입니다. 4. 도형 문제: 도형에 관한 간단한 문제를... 
초등5학년수학문제	... 국어를 좋아하는 학생은 수학글 좋아하 는 학생의 제보다 8명이 적다고 한다. 국어를 좋아하 는 학생이 20명이면 혜란이네 반 학생은 모두 몇 명인 가? )명 국어를 좋아하는 학생수 : ㅁ = 20 수학을 좋아하는 학생수 :ㅁ+8 = 20+8... 
폴수학을 들어도 될까요??	... 시간의 압박이 있기는 하죠ㅜㅜ 그래도 폴수학 좋아요. 그리고 폴수학 한번 들은다음에 심화문제위주로 200제 이런거 한번 들으세요 박승동꺼나 라승균 한석원 추천합니다. 그리고 나면 어느정도 수준 올라갈꺼에요 좋은결과 있으세요 
중학수학!!! 빨리답해주실수록 좋아요 ㅠㅠ	저저 오늘도 문제를들고왔습네다 ㅠㅜ 감사내공될수있으면드릴께요 중학수학이에요 문제드릴께요 ! 아! 식자세히말해주실수록 엄청따따블좋아요! 1]일차방정식 x-3분의 2x-a[분수]=a+2의... 
초등2학년 수학문제집 추천해주세요	저희 애가 수학을 좋아는 하는데.. 점점 지루해 하고 재미 없어 하더라구요그리고 연산 부분이 너무 약하구요그래서 초등2학년 수학문제집을 고민중인데쉽고 재미있게 공부를 했으면 하는데 재미있는 초등2학년... 
예비고등학생 수학인강추천	... 들어가기전 혼자서 EBS 인강들으면서 해보려고 하는데 정승제쌤 수학의왕도가 좋아요? 아니면 50일수학이 좋아요..?!  수학인강으로는 ebs와 병행으로 나인 추천드립니다 - 실시간 강의 - 성적분석 - 1:1 맞춤 학습법 나인스쿨 무료체험
쎈수학 가격 내공35	"... 제친구가 쎈수학을 하는데요 쎈수학좋아요,,ㅋㅋ 쎈수학은 만삼천원 전 뜀틀이라고 하는데요 수학기초가 아예업으시면 제가 하는걸로,,,,, 전 뜀틀중학수학이라고 마더텅?? 이라는 출판사에서 만든거쓰고 잇는데요 그건 문제수가... "
대성 수학 괜찮나요?	재수생인데 문과라 나머지 과목은 다 대성이 좋아보이는데 수학 하나땜에 메가를 사야되나 고민되네요 수능때 수학만 4등급정도 나왔는데 대성꺼 들어도 충분히 올릴 수 있나요? 현우진이 컨텐츠가 좋긴 하지만 대성도 수학이 꿀리진... 
예비고1 수학고민	"... 대한민국에서 수학 좋아서 공부하는 학생들 10명중 1명도 안됩니다. 어차피 수학은 대한민국 모든 학생이 고3까지 배워야 하는거고 결승점은 똑같습니다. 다른 친구들이 조금 빨리 갈뿐, 가다보면 지쳐서 쉬어야 할때도 있겠죠. 각자... "
수학선생님이 되고싶은데..	"... 수학을 좋아 하시겠네요! 그러다면 벌써 수학교사가 되실 수 있는 조건 중에 하나는 준비가 되셨습니다 그런 마음을 계속해서 가질 수 있도록 꾸준히 노력하세요 다음으로는 ""가르치는 것을 좋아하느냐?""가 문제입니다 교사는... "
수학잘하는방법(문제집)	... 설명이 엄청잘되어있는것.거의 문제반설명반 ----(좀심했나-_-)하여튼 설명이잘되어있고 무척 쉬운거요 그런데 투탑수학좋아요? 저가 학원에서 개념편하고유형편 풀고있는데 좀 많이 어려워서요. 질문은요.... 질문1:투탑수학 좋아요?... 
전체 단원 문제 주세요 ㅜㅜ 최상위 수학이면 더 좋아요!!	... 최상위 수학 아니어도 대환영이니까 6-1 전체 단원 아무 문제 주세요.. 채점도 해야하니 답안지랑 해설도... 최상위수학 6-1 pdf 첨부했습니다! 답지까지 하면 용량이 커져서 첨부가 안되더라고요 ㅠㅠㅠ 이메일을... 
수학도서	(1)수학귀신 (2)수학이좋아요 (3)수학이지뭐야 방학숙제로 이 3권을 읽었는데 무슨내용인지하나도모르겠어요 내용을따로따로 분리해서 하나씩달아주세요 저도 방학숙제로 읽게 되었어요..그래도 님은 괜찮네요 저는 5권을 읽어야 되는... 
수학 6학년 2단원 각기둥 어려운 문제좀여... 	"수학 6학년 2단원 각기둥 어려운 문제좀여 많을수록좋아여  가로의 길이가 5cm, 세로의 길이가 10cm이고 높이가 15cm인 각기둥에서 가로를 5cm늘리고 세로를 7cm줄이고 높이를 10cm를 늘렸을때 늘리기 전 각기둥의 부피+늘린... "
셀파가 좋아요?? 쎈이 좋아요?? 백점맞는 수학이 좋아요???	... ㅠㅠ 전 셀파!! 강력 추천 합니돠아아아아아아아앙!  제가 둘다해봤었는데 백점맞는 수학이 짱이에요 책도 여러개로 나눠져있고 날개북이나 막그런것도 있어서 성취도 준비할대 따 좋아요
초6 수학 강의 뭐가 좋아요??	"제가 수학 인강/강의를 차근차근 시작하려고요, 초6 강의고 괜찮은거 다 알려주세요 (질문 처음이네요;;) 자세히 적어주세요! ebs들으세여 "
학교수학쌤이좋아요..	... ㅎ 선생님으로써좋아하는건지 남자로좋아하는건지생각해봣는데 도저히 선생님으로써는아닌거같애여.. 노래도잘불루고 기타도잘치고수학도잘하고 음악도가르친데요ㅠ 춤도너무잘춰요ㅠ 어떻해야돼죠ㅠㅠ 제발도아주세요ㅠ... 
수학여행때 좋아 하는 사람 한태 잘보이기	제가요 수학여행대 장기 자랑대 3셋이서 노래 부를 건데 곡은 SG워너비 걸로 하는데요 제가 좋아 하는 여자애 한태 잘 보일라면 엏떻하죠? 1 .어떤 노래부를 까요(아리랑 예상) 아 참고로 그 여자애는 활발하기도 하고 소심하기도함 2... 
구몬 이야기수학 언제 시작하면 좋아요?	구몬 이야기수학 몇 살때 시작하면 좋아요?  구몬 수학을 왜해요? 왜 시켜요? 황농문 교수의 몰입을 시키세요. 아니 시키지 말고 직접 해보세요. 그래서 아이가 따라하게 하세요. https://www.youtube.com/watch?v=zyba8_B2f1I
대구지산동에좋은수학학원	... 지산청구아파트 입구 맞은편 마스터수학 좋아요. 원장님이 직강 하시는데... 10년 경력이라시던데.... 진짜 쉽게 가르쳐 주시공 모른다고 절대 화내시는 일 없어요. 제 조카는 수학 진짜 못한다고 저희 언니가 속상해 했었거든요. 근데... 
수학 그닥 안좋아하는데 도형은 좋아요	... 도형만 잘해요 수학에서 도형만 그리고 이해 한가는것들 이미지로 이해하는걸 좋아하는데 .. 이런 유형은 어케 공부하죠 공간지각능력이 뛰어나신 겁니다 일반적인 고등수학은 이미지로 이해하긴 힘들다고 생각되네요 
가운동 영어과외 수학과외 어디가 좋아요?	"고등학교1학년 수학과외 영어과외 어디서 찾아볼수 있나요?... 가운동수학과외 선생님 계실까요? 정말로 노하우 많고... 가운동수학과외 가운동영어과외 알려주세요  안녕하세요... 영어 수학 학원, 단과학원, 영수 종합학원, 국어 과학... "
초등2학년 수학문제집 추천해주세요	저희 애가 수학을 좋아는 하는데.. 점점 지루해 하고 재미 없어 하더라구요그리고 연산 부분이 너무 약하구요그래서 초등2학년 수학문제집을 고민중인데쉽고 재미있게 공부를 했으면 하는데 재미있는 초등2학년 수학문제집 좀... 
이투스 수학 강의	... 메가 스터디랑 대성은 수학 쌤 좋아보이던데 저는 딱히 못 찾겠더라구요. 이제 기말 5주 정도 남았는데 들을만한 강의 추천 부탁드립니다. 개념+문제로 추천 해주세요 정승제 생선님을 추천합니다. 개념은 모든 수학 선생님 중에서도... 
해운대 부근 수학 학원 어디가 좋아요?	"고등학생인데요 부산 해운대쪽에 살고 있고요 제가 수학을 정말 워낙에 못해서 수학학원을 좀 다녀보려고 알아보고 있는데요. 수학은 정말 싫어하는데, 이대로 수학을 포기하기에는 아닌듯 싶어서 노력이라도 해서 수학 성적좀 올려볼까... "
초등수학 학습지 좋아요?	"... 있어요 수학 어려워 하는 딸아이를 위해 전 디딤돌수학 하고 있어요... 풀어내더라구요 수학은 기본이 잘 되어 있어야 어제운 문제를 만나보 겁을 먹지... 아이가 수학자신감을 가지게 되어서 잘 골랐다 싶더라구요. 서점에서 원리, 기본... "
우등생수학 좋아요?	수학 공부 하기에 좋고 기초 잡기에 좋은게 우등생수학이라고 하던데 혹시 우등생수학 초등 아이가 풀기에 좋은가요?... 우등생수학으로 공부 시키기 전에 궁금해서 이렇게 질문 드려요 안녕하세요 천재교육 문제집 서포터즈 입니다... 
수학교사	"... 수학을 좋아 하신다고요! 그러다면 벌써 수학교사가 되실 수 있는 조건중에 하나는 준비가 되셨습니다 그런 마음을 계속해서 가질 수 있도록 꾸준히 노력하세요 다음으로는 ""가르치는 것을 좋아 하느냐?""가 문제입니다 교사는... "
안좋아요. 영어과외 수학과외 통해서 내신 올려볼려고... 	... 내신위주로 공부를 하고 있는데 아무래도 영어과외 수학과외 통해서 내신 올려볼려 해요. 도와주세요.  안녕하세요! 부산남고 영어 과외 수학 과외 전문 내신 관리 선생님 기쌤 입니다! 아무래도 한참 중요한 고2 경우에는... 
중1 수학 독학	"... 쎈 수학이 좋아고 하는데 정말인가요?  안녕하세요 천재교육 문제집 지식파트너 입니다 중1인데 독학으로 할 수학문제집을 찾고 계시는군요 개념정리가 잘되어있어서 혼자서도 이해하기 수월한 문제집을 찾으신다면, 해결의법칙을... "
고3 공대 수학 학과 진로 질문	... 나는 물리도 좋고 수학도 좋아 -> 기계공학과 나는 화학도 좋고 수학도 좋다 -> 화학공학과 . . 생명+수학 -> 생명공학과 이런식으로 수학이 베이스인 학부가 대학교에는 매우 많으니 목표로 하시는 학교 홈페이지에서 개설된 과를... 
"초등학교5학년 논술,수학 어디가제일좋아요?"	"저는 이제 초등학생5학년이 되는데 논술,수학어디가제일좋아요  논술은 잘 몰라서 수학 추천할게요 구몬학습이라고 학습지가 있는데 서술형은 나오지 않고 계산만 하는 건데요 제가 이거해서 5학년 끝날때 중1 수준이 됬어요. 사람마다... "
"1. 국어, 도덕, 역사, 수학, 과"	"... 그렇다고 다른 과목을 소홀히 해서는 안 됩니다. 도덕, 역사, 기술가정도 함께 하시되, 위 과목을 중점적으로 하시는 게 좋아요. 2. 수학이나 과학 같은 과목은 오답노트 쓰는데 좋은가요? 네. 오답노트를 쓰면 도움이 될 것 같습니다. "
안좋아요. 영어과외 수학과외 통해서 내신 올려볼려고... 	"... 내신위주로 공부를 하고 있는데 아무래도 영어과외 수학과외 통해서 내신 올려볼려 해요. 도와주세요. 안녕하세요 부산과외는 각 과목별 전문선생님과 팀을이뤄 학생,성인 분들을 대상으로 수업하고 있는데요 보통 과외 수업은 상담... "
수학문제집 모가좋아요?	"... 개념편으로 개념 정리를 하면서 처음에는 쉬운 문제 위주로 풀어보며 개념을 익히고, 유형편에 있는 다양한 문제들을 풀면서 심화 문제에 대한 연습을 하면 좋아요~ 중등 인강 사이트에 수박씨 닷컴이 있는데요. 수학... "
수학정석.. 문제 좋아요?	... 정석 문제 안좋아요!!!!!!!! 정석이라면 혹시 그 초록색 껍데기 홍성대? 그거 한 80년댄가부터 똑같은 글자 그대로... 다른거 푸세요 일단 문제집 선정은 학교선생님한테 도움청하는게 제일좋아요. 선생님들이 문제집에서 힌트를 얻고... 
수학 계산 노트에다 하는게 좋아요??	수학 계산 노트에다 하는게 좋아요?? 제 생각은 노트는 크고 넓은데 나중에 시험 칠때 자리가 너무 작아서 적응이 안되지 않나요.? 저희학교 시험지가 막 수능 칠때 그 종이처럼 막 큰게 아니라서요.. 저는 수학 공책을 많이 쓰는 편입니다... 
중학 수학 문제 급해요....	"우리중학교 1학년 전체 학생 390명 중에서,국어를 좋아하는 학생이 280명,수학을 좋아하는 학생이 210명 두 과목 다 좋아하지 않는 학생이 50명이다 수학만 좋아 하는 학생 수를 구하면? 1번 30명 2번 60명 3번 90명 4번 120명... "
중1 수학 독학	... 쎈 수학이 좋아고 하는데 정말인가요?  유투브에 강의채널이 많아요 돈도 안들고 짜투리시간에 보기좋은 영상추천드림 https://www.youtube.com/c/MathPencil 5분내 영상으로 (음성없음) 기초부터 중등수학을 그림으로 알려주는... 
김포 걸포동 영어과외 수학과외 북변동 까지 좋아요... 	... 김포 걸포동 수학 영어 과외 수업에 궁금하신 부분과 질문을 읽고 효율적인 수업을 받을 수 있는 방법과 실수 없는... 국어 영어 수학 과학 사회등 과목별 전문선생님들과 함께 과학적 진단으로 학습의 문제점을 파악하고 각개인에게... 
수학여행이 좋아요?수련회가 좋아요?11시까지 써주세요!!	... 둘중에 무엇이더 좋아요? 그리고 수학영행은 밤에 다른방에서 놀고 시끄럼게 떠들어도 돼나요?글구 다른방에서 자도돼요? 수학여행은 장기자랑이 있어요?혹사 수학여행도 교관이있어요? 수학여행은 자유가 많아요? 빨리... 
리틀수학북스 ..탄탄수학... 어떤것이 좋아여???	"... 그림책 각 권마다 활용할 수 있는 워크북도 12권 포함되어 있고, 스티커, 놀이 활동 자료도 다 포함되어 있어서 엄마표로 즐겁고 재미있게 수학 배우기에 정말 좋아요. 또 앱도 있어서 책의 내용 그대로 어플로 책도 보고, 문제도 풀고... "
급함>>> 중곡동 수학 단과 학원 어디가 좋아요??	"... 사이구요, 수학이 다른과목에비해 점수가 좀 많이 떨어져 수학때문에 평균 다 깍아 먹어서ㅜㅜㅜㅜ 수학 단과를... 중곡동에서 수학단과 괜찮은 학원좀 추천해주세요^ -^*  솔직히 질문자님 중등생같은데 (아! 질문한게... "
중학교 수학 참고서 어떤 교재가 좋아요	"... 저도 성적은 중상위권이라고 보는데여 외국어 실력이 좀 따려서 그렇지 수학은 무지좋아합니다 제가 우연히 서점에서 하이레벨 수학 참고서를 보게 되었는데 문제가 상당히 많더라구요,,,, 목차도 한문으로 ㅆ여져있는 것이 사람... "
"고등학생 수학 학원, 독학"	... 해주고 싶은 말이 더 많지만 너무 길어지거 같아 여기까지 할께요 ㅎㅎ 꼭 제말이 질문자님께 큰 도움이 되길 바래여!! *만약 예비고1이면 ebs고등예비과정(수학)도 좋아요! 박자영선생님께서 진짜 재미있고 친절하게 알려주십니다!~~ 
김포 걸포동 영어과외 수학과외 북변동 까지 좋아요... 	"... 영어과외 수학과외 알아보시나봐요, 저는 의지를 가질수 있도록... 북변동수학과외 일대일로 수업하고 있습니다. 동네에 아이들 다 다니는... 걸포동영어과외 걸포동수학과외 북변동영어과외 북변동수학과외 개인과외구하기 개인과외... "
예비고2 수학!!! 과외가 좋아요 학원이 좋아요?	... 수학을 너무 못하고 힘들어하고 있습니다. 지금 학원을... 그래도 계속 질문하니까 죄송하긴 하지만 저도 수학... 성질급한 수학을 배우고 있는 것 같아요. 이제 한달... 중요한 수학과목에서 개념을 확실히 짚어주지 않고 있으며 - 설상... 
중2 수학 문제집	"... 수학의 바이블이 좋아보이던데 수학의 바이블 괜찮나요?  안녕하세요 수박씨 멘토입니다. 수학 문제집은 현재 수학의 기본이 잘 안 잡혀 있으면 비상에서 나온 개념플러스 유형(라이트)편을, 개념 정리와 다양한 유형의 문제를 많이... "
"중학교 1학년 수학, 집합"	"중학교 1학년 수학, 집합과자연수 문제 1개만 풀어주세요(풀이과정 자세하게) Q.민지네 반 35명의 학생 중에서 수학을 좋아하는 학생은 19명, 영어를 좋아하는 학생은15명, 두 과목 모두 좋아하지 않는 학생은 7명이다. 이 때, 수학은... "
수학이 너무 좋아요.	"제가 중학교 2학년이 되고 나서 수학이 너무 좋아졌어요. 복잡한 수학식이나 수학과 관련된 영화 또는 사이트 아시는것 있으면 답변 부탁드려요. (사이트는 수학과 관련된 사이트, 수학 사진이나 어려운 공식같은게 많은 사진이 있는곳 뭐... "
제가 수학을 좋아하는데...	"제가 수학을 좋아하는데, 좋아하는거에 비해서 많이 못해요. 그래서 이 이야기를 말했더니 좋아하는것과 잘하는것은 다르다고 하고, 좋아한다고 해서 잘하는거 아니다. 뭐 이렇게 말하더라고요... 그리고 뭐 몇몇 사람들은 장난스럽게... "
학교 수학 선생님이 좋아요ㅜㅜㅜ	"제가 여자고 수학 선생님도 여자라 좀 웃길 수도 있지만 수학 선생님이 대박좋아요,, 수학 선생님은 키도 크시고 얼굴이 딱 봤을 때 반할 얼굴은 아니고요 볼수록 매력있고 한 쪽은 무쌍 한 쪽은 속쌍에 긴 눈매를 가지고 계시고 코도... "
중학교 수학 문제집	... 그리고 체크체크 수학도 좋아요. 체크체크는 본교제와 워크북이라는 걸로 두개로 나누어 지는데요. 워크북은 계산/개녕/잘틀리는 문제 등을 잡아줘서 좋아요. 거기다 서술형까지 있으니 금상첨화네요. 물론 제 느낌이구요. ^^~ 일단... 
초등 수학 어떤브랜드가 좋아요???	"디딤돌이나 왕수학, 올림수학 ...주변에서 이런 것들 많이 하더군요... 그중에서 어떤게 좋은가요?? 각 브랜드의... 제가 왕수학 다니거든요. 보충 진짜 많이 해줘요. 짜증날 정도로요. 내가 다니는 왕수학만 그런건지는 모르겠지만요.... "
개념원리 수학 좋나요?	제가 수학 공부하려 하는대요 개념원리 수학 좋아요? 좋다면 개념원리랑 같이 공부할 책도 써주세요  많은 사람들이 개념원리 보죠ㅋㅋ 개념원리 좋아요~ 몇학년이세요? 완자도 괜찮은것 같던데.. 음 그래도 무엇보다는 한가지 문제집... 
고1 수학과외 안늦었나요?	... 제가 다른 건 그냥 평범한데 특히 수학 성적이 완전 안 좋아요ㅠ 기초가 안 잡혀 있어요. 엄마가 과외라도 알아 보는 게 어떻겠냐고 하셔서.. 고민 중이거든요 근데 딱히 알아 보려 해도 어떻게 알아봐야 하나 싶어서요. 친구들한테... 
정말 수학 잘 하고 싶어요	... 근데 수학을 잘하는건 아닌데 정말 수학이 좋아요 수학 공부할때마다 그렇게 좋아요 근데 선생님은 전 안된다고 비웃기만해요 원래 문돌이 였는데 수학 잘하고싶고 이과로 옮겼어요 그런데 결과가 너무 안좋아요 다른 진로... 
개념원리 수학 좋나요?	제가 수학 공부하려 하는대요 개념원리 수학 좋아요? 좋다면 개념원리랑 같이 공부할 책도 써주세요  개념 원리 좋습니다 .... 개념 원리랑 같이 하실거면요 .. 개념원리는 초보적인 수준부터 끌어 올리는거니 고난도 수학 (지학사 꺼) 풀어... 
바라보는데 김포 영어과외 수학과외 어디가 좋아요?	아이는 아직은 중학생이지만 고등학교 과정 진도 나가면서 현재 수준에 맞는 수학진도로 복습해주고 선행나가주는 수학과외 원해요 김포수학과외 찾는 김에 이번에 김포영어과외 까지 알아보려고합니다 진도 빨리 빼주실 수 있는... 
안양 고1 수학과외 영어과외 구해봅니다	... 지금 1학기 내신성적이 너무 안좋아 안양수학과외 안양영어과외 생각중입니다 너무 비싸면 엄마가 안된다고 하는데 어디로 알아보는게 좋을까요? 유지에 유용한 학습보조도구로 활용할 수 있다. 가능성에 대한 연구(임정훈·성은모... 
중1 수학...	... 그리고 음 투탑 중1수학도 좋아요. 제가 다 어릴때 풀었던거에요. 저도 독학을 했었는데. 수학만 100점이 나오더군요. 지금 만약 고등학교꺼 바로들어가시면 아무것도 모르시고 막막하실꺼에요. 그러시니까요 힘들더라도... 
저는 수학이 너무 좋아요......ㅡㅡ	전 수학이 아주 재미있어요 언어나 암기과목은 최악이져;; 제가 이번에... 문과수학만해서 사실 과탐하구 수학2는 하나도모르죠;; 그래서 그냥 인문계로... 선택물리는 말안해도 아실거라 믿구여ㅡㅡ 수학은 공수랑 수1은 문과보다... 
수학학원 보내려고 하는데여 화봉동 쪽도 좋아요	... 이여도 좋아요  안녕하세요 울산 송정지구 안에 있는 수학학원이자 영어학원이에요! 화봉고등학교 학생들이 많이 다니고 있어요. 중학생이나 고등 내신 위주로 지도하고 있으며 문자나 전화를 주시면 꼼꼼하게 상담이 가능해요.... 
부평구 산곡동 남남수 수학학원이 그렇게 좋아요?	"... 어떻점이 좋아요?? 남남수 수학학원이 수학성적 45점맞은 학생은 98점으로, 52점짜리를 100점으로, 80점대를 90점 후반으로 올렸다고 광고하고 다니는데.... 사실인가요???? ( 이건 구라인듯-_-;;) 학원 수업방식좀 자세히 설명해주세요!!!... "
특강수학 !!!!!!!!!!!!!	"특강수학 좋아요 ? 제가 중학교 올라와서부터 공부를 안 했는데... 초등학교 때부터 수학을 무지 싫어했거든요, 그래서 중학교 때부터 연을 끊었는데... 중3되니까 참 막막하더군요. 배운 게 없어서... 정말 공부 좀 할 껄 이라는 생각 밖에... "
수학학원 어디가 괜찮아요?	... 수학 좀 열심히 해볼라구요 초 4수학이 어렵다잖아요 괜찮은 수학학원 추천 좀 해주세요 지점 있는거면 더 좋구요 교재나 뭐 그런거 괜찮은데로 샘들 좋구요  사시는 위치를 안적어주셧는데 강남사시면 대치동에 손정희수학좋아요!
"물상,수학기초 잡는법 !"	"... 님이 수학을 좋아 하신다 그러셧는데요 그러면 수학 쉬워집니다. 저도 엤날에는 수학 싫었거든요, 근데 중2 겨울방학때 10-가,나 와 수1 을 살짝 배우니깐 정말 재미있어지더군요, 그래서 수학에 관심이 많아지고 한문제라도 더... "
고2 수학여행 캐리어 뭐가 좋아여??	말그대로 이제 수학여행을 가서 캐리어 사려구요 20인치 사려는데 그냥 검색하면 뭔가 딱딱해보이는 디자인밖에 안보여서ㅜ 조금이라도 귀엽거나 이쁜 디자인 요소가 있는거로 추천해주세요!!  이런거... 
수학이 너무 좋아요.	"... 그런 기분때문이인거 같기도합니다, 하지만 내가 이걸 풀어서 맞았다는게 또, 뿌듯하고 그런 것 때문에 수학을 너무 좋아하는거같습니다. 학교에서도 수학경시반이고 교장선생님도 제 이름압니다. 전 나중에 수학쪽으로... "
수학 계산 노트에다 하는게 좋아요??	수학 계산 노트에다 하는게 좋아요?? 제 생각은 노트는 크고 넓은데 나중에 시험 칠때 자리가 너무 작아서 적응이 안되지 않나요.? 저희학교 시험지가 막 수능 칠때 그 종이처럼 막 큰게 아니라서요..  음....6칸짜리 수학공책쓰시거나 그... 
수학학원 어디가 좋아요?	"제가 개신동 푸르지오 아파트에 사는데 수학학원 어디가 좋아요? 그리고 논술학원도 좀 추천해 주세요 종합학원 끊고 수학학원 다니려고 그러는데 이사와서 잘 모르겠어요 참고로 중학생입니다 올림수학학원이 좋다는데,, 그래도,, 잘... "
수학 좋아하시는 분들 ㅠㅠ 질문 있습니다.	"... 수학 좋아하시는 분들 수학 좋아 할 방법 없나요? 지금 이 글을 보시는 ........... 수학을 좋아하시는 분들 게임보다 수학이 좋나요? 수학 정말 좋아할 수 있는 방법 없을까요?  쉬운 문제부터 푸세요,,^^ 일단 수학에 대해 자신감을... "
수학 질문합니다! (빠를수록 좋아요 :))	"승준이와 유진이가 같은 집에서 동시에 출발하여 서로 반대 방향으로 직선 도로를 따라 걷고 있는데 승준이는 시속 4km, 유진이는 시속 6km로 걸을 때, 승준이와 유진이가 3.5km 이상 떨어지려면 몇 분 이상 걸어야하는가?... "
동백에 수학학원 어디가 좋아요? 지금 중1인데... 	... 동백초등수학학원 예비중 예비고 고1 고2 고3 중1 중2 중3 수행평가대비 수행평가잘하는곳 동백중등영어학원 동백중등수학학원 동백고등영어학원 동백고등수학학원... 기흥구초등수학학원 기흥구중등영어학원 기흥구중등수학학원... 
중2 수학 문제집	... 수학의 바이블이 좋아보이던데 수학의 바이블 괜찮나요? 수학은 개념이해+문제유형이 필수입니다 개념서는 개념원리 수학의바이블 문제집은 난이도 순서로 rpm 쎈 일품 에이급수학 추천 합니다 이 포스팅은 쿠팡 파트너스 활동의... 
수학 포기	"... 사실상 수학을 포기한다한들 대학을 못가진않아요 단지 학교 최저등급맞춘다고 성적을 내는거지,, 대학교도 높은곳아니고 그냥 가시는거라면 사실상 수학포기하셔도됩니다 저도 수학은 좋아는했지만 점수가 안나왔는데도... "
어려운수학문제 풀면 머리가 좋아 지나요?	어려운수학문제 풀면 머리가 좋아 지나요?  물론입니다. 그리고 머리가 좋아짐은 아이큐나 다른 창의성 테스트로 합니다. 대개 수학적 원리에 따라 측정하므로 어려운 수학문제를 풀면 점수가 올라갈 수 밖에 없습니다.
15살만 답 해주세요 님들은 수학이랑	15살만 답 해주세요 님들은 수학이랑 영어 중에 뭐가 더 좋아요? 둘 다 싫어요 금지 수학이 더 좋아요 전 도형이 쉬어갖고 
[내공] 수학 학원 어디가 좋아요?	"... 수학 학원을 다니려고 합니다... 단순히 내신을 위해서 다니는 학원이 아닌, 심화된 내용과 경시대회 정도의... 수학경시대회문제등 여러문제를 가르키고요 또한 중학교 3학년때부터 sky반(s=서울대,k=고려대,y=연세대)반을 만들어... "
예비중 수학 인터넷 강의좀 추천해주세요 !	"... 제가 수학 인터넷강의를 보려고 하는데 어떤걸 해야할지 잘 모르겠어요,, 제가 수학을 안좋아 하는편이지만? 상위권 입니다.. 추천 부탁 드려요 !  수학은 학생의 스타일과 현재 상태를 명확히 알고 선택을 하셔야 해요. 인강은... "
고1 수학과외 안늦었나요?	... 제가 다른 건 그냥 평범한데 특히 수학 성적이 완전 안 좋아요ㅠ 기초가 안 잡혀 있어요. 엄마가 과외라도 알아 보는 게 어떻겠냐고 하셔서.. 고민 중이거든요 근데 딱히 알아 보려 해도 어떻게 알아봐야 하나 싶어서요. 친구들한테... 
"사고력 수학 학원 어디가 좋아요? 와이즈만, 소마... "	아이의 사고력을 길러줄까하고 수학학원을 알아보고... 유명하지만 수학 수업도 훌륭하다고 하는데 어떤가요?... 그저 학교 수학시간에 수업 잘 따라가고 사고력이... 시매쓰는 수학만 와이즈만은 수학 과학을 다루는 곳입니다. 그래서... 
수학교육과 수학과	... 수학에 엄청난 재능이 있어서 희망을 하는건 아니고 수학을 좋아하고 문제를 풀때 기분이 좋아요! 수학교육과 간다면 진로는 중학교 수학선생님을 희망합니다! 그런데 임용고시가 힘들다고 많이들 말하더라구요 그래서 중학교... 
6학년 수학 도와주세요~~	"... => 48*(2/3)= 32(명)<체육 좋아하는학생> 32*(3/4)= 24(명)<수학 좋아하는학생> 2.반비례관계인 것을 모두 구하시오. => 답;3,4 1.원의 지름과 원주 < 지름 , 지름*π> 2.한개에 400원인 아이스크림의 수와 아이스크림의값 3.넓이가... "
"수학은 못하는데 사고력은 좋아요,"	"... 저 정말 수학 ... 못하거든요 ㅠㅠ 많이요, 정말..ㅠ 시험보면, 아예 못풀구요.. 수학만 보면 어지럽고.,, 옛날에는... 수학을 배우는 못적은 사고력, 다시말해 생각하는 힘을... 전 정말 저를 알고 싶어요, 수학,, 포기한지 오래됐구... "
예비중 중1수학 내공50	예비중인데여 인강을 들으면서 풀 수 있는 중1수학 문제집 좀 추천해주세요  디딤돌 최상위 수학이 좋아요.개념이나 유형 같은 문제들은 인강이 없지만 마지막에 나오는 문제들은 어려운 문제를 유튜브로 찾아보거나 QR을 찍으면... 
송정동 과 탄벌동 영어과외 수학과외 어디가 좋아요?	"경기 광주 송정동수학과외 송정동영어과외 추천... 영어,수학 잘따라가고는 있는데 고등선행을 준비해주고 싶어서... 송정동수학 영어과외 또는 가까운 탄벌동영어과외 탄벌동수학과외 추천 부탁드려 봅니다.  안녕하세요^^ 8년동안... "
50일 수학 노베이스한테 쓰기 좋아요?	... 50일 수학 완전 노베이스에게 쓰기 좋아요?  진도를 목표로 한다면 학원을 가시면 진도 엄청빠르게 빼줍니다. 그러나 결국 성적을 올리려면 수준을 올려야 합니다. 조급하게 마음먹지 마시고 천천히 하나하나 단계를 밟으세요. 시간이... 
6학년12월 점프올 수학문제요...	"... 이중 4분의3은 체육을 좋아하고,나머지의 3분의2는 수학을 좋아 한다고 합니다.수학을 좋아하는 학생은 몇명인가요??? 7.넓이가36제곱센치미터인 정사각형이 있습니다.이 사각형의 한 변의 길이를 각각 2분의1로 줄이면... "
수학학원 보내려고 하는데여 화봉동 쪽도 좋아요	안녕하세요 울산 송정영어학원 보내려고 하는데요 화봉고 1학년 친구이고 학원은 처음으로 다니려고 하고 있어요 송정수학학원 고등 내신 위주로 잘 가르치는 곳 아시는 분 알려주세요 화봉동 쪽 이여도 좋아요  질문 꼼꼼하게... 
화명동 수학학원 잘가르쳐주면 좋아요~	... 그런데 수학에 자신이 없어용ㅜㅜ 그래서 슈학학원을 다니려고 하는데 어디로 다녀야 할지 수학학원 결정을... 화명동수학학원 화명동고등학생수학학원 화명동수학학원추천 학습적으로 또한 멘토 선생님으로서 적극적으로... 
구리에 영어 수학학원 어디가 좋아요?	... 영어랑 수학 학원을 보내고 싶은데 어디로 보내야할지 막막합니다. 정보도... 영어 수학학원 좀 알려주세요~~~ 최촌마을가기전 캔수학학원을추천드리구요... 애플영어학원에서길건너캔수학학원이있기때문에눈앞에바로보여요... 
수학 잘 하는 법	수학 잘 하는 법 알려주세요 곱하기 암산도 제대로 못하고 이해력 기억력 다 안 좋아요 어떻게 하면 수학 잘하고 친구들하고 문제 같이 풀까요 맨날 수학시간엔 화장실 가는척 애들 수학풀때 빠져있어요 쉬운 문제집(개념 +유형) 이런거... 
수학과외 영어과외 초중고학생들 재밌게 가르치면 좋아... 	... 아이들이 좋아할 것 같네요 세남매를 키우다보니 좀 재밌고 유쾌하게 수업 하길 원하는데 혹시 가능하실까요??  안녕하세요^^ 유쾌하고 발랄한 교사 꽃샌님입니다. 신불당수학과외 경력11년차로 오랜기간 아이들 내신과 학습관리를... 
수학학원이 너무 않좋아요	수학학원이 너무 안좋아요 책에 나와있는 내용 읽어주고 문제푸는것만 반복해요 선행학습도 잘 못알려주고 칠판이 아닌 말로만 설명하고….6개월동안 다녔는데 날린 느낌이에요 충격받은건 반 5명중에 저만 중2고 나머지는... 
수학 잘하는 법좀 알려주세요 ㅜㅜ	... 예 필요합니다 독학을 위해 꼴찌도 1등만드는 책을 추천해주겠습니다 전 중3이고 중3 4월달부어 공부했는데 지금 수학이 좋아 수열을 하고있습니다. 물론 제가 공부하는 책은 현교육과정을 따르지않습니다. 2.노력해도 안되는데요... 
수학뉴런좋아여?	제목은 곳 내용  네 좋습니다
급함>>> 중곡동 수학 단과 학원 어디가 좋아요??	"... 사이구요, 수학이 다른과목에비해 점수가 좀 많이 떨어져 수학때문에 평균 다 깍아 먹어서ㅜㅜㅜㅜ 수학 단과를... 중곡동에서 수학단과 괜찮은 학원좀 추천해주세요^ -^*  전 면목동쪽으로 가는 중곡동 학원은 잘 모르지만 아마 제가... "
급함>>> 중곡동 수학 단과 학원 어디가 좋아요??	"... 사이구요, 수학이 다른과목에비해 점수가 좀 많이 떨어져 수학때문에 평균 다 깍아 먹어서ㅜㅜㅜㅜ 수학 단과를... 중곡동에서 수학단과 괜찮은 학원좀 추천해주세요^ -^*  용곡중학교애들은 대성학원, 전문가집단에 제일 많이 다니죠... "
중2수학문제집[독학]내공[20]	... 완자수학 좋나요?? 3.내공의힘은 해설잘나왓나요? 깔금하게해주시거나 좋은글써주시면 감사내공 ㄱㄱ  1. (지학사)특강수학 추천 2. 완자수학 좋아요 ^^ 3. 내공의힘은 해설이잘나왓어요 좋은글써주엇으니 감사내공 ㅅㄱ하실래요?
쎈 수학 효과	... 쎈 수학 언니가 추천해 준거라서.. 좀 믿을수가 없엇어요. 그래서 쎈 수학 효과점;; ㅎㅎ 답변해주세요 내공 100 걸어요.  쎈수학 좋아요 뮨제 유형도 좋고 근데 단점은 개념이 완전히 박혀있지 않은상태에서푸시면 소용없어요
"풀리는 수학, 풀리 이거 좋아요?"	제곧내제곧내  좋은데요?
중1 수학 독학	... 쎈 수학이 좋아고 하는데 정말인가요?  처음 중 1 과정을 배우는데 쎈을 풀기에는 어려울 수 있어요. 처음부터 어려운 문제집을 풀면 스트레스 받아요. 처음에는 개념을 공부하니 (개념+유형) 라이트 가 좋아요.
{30}대치동 수학학원 추천이요 내공30 내공올인~	... 대치동에 개념의힘 이란 수학학원 좋아요? 질문2. 개념의힘에 대해 설명해주세요 질문3. 다른 학원 추천요~( 페르마나 외고전문 학원 말고 고등부중심인데 추천해주세요) 학원 추천 하실떄 전화번호랑 그 학원이 어떤학원인지... 
예비고1 수학고민	안녕하세요 내년에 고등학교 올라가는 예비고1인데 제가 중학수학 성적이 좋아본 적이 없어서 요즘에 중학수학 총정리책으로 복습하고 있어요 근데 개념강의 들은 후에 문제를 푸는데 1문제라도 틀리면 자신감을 잃는편이에요... 그... 
"예비고1인데요, 수학문제집 뭐가 좋아요?"	"... 중3인 암울한 여아입니다 수학은 평소에 잘해도 시험만 치면 말아먹는... 그래서 고등학교 가서도 그 꼴 날것 같아서 고등학교 수학 혼자서라도 독학할... ^^ 제가 볼 땐 님에게는 나, 수학문제집이 딱 맞을 꺼 같은데... 문제가 유형별로... "
중1후반부부터의 수학선행	... 선행좀 진짜 제대로 알려주세요~ 참고로 저는 외고 준비하고 있어용~ 도와주세요!  쎈수학좋아요~~ㅋㅋ 난이도별로 나누어져있구요~ 기초문제들만풀어도 제학년가면 심화문제는 풀수는있을거에요^^ 저는 그랬다구요...
수학의 샘 좋아요?	좋아요????? 그저 그래요. 
수학정석.. 문제 좋아요?	"... 정석, 개념원리, 신사고 기본 학습서 등등 알려진 수학 참고서들은 모두 좋습니다~ 다만 개인적인 차이들이 있어서 어떤 책이 좋다,나쁘다 하는 것이죠~ 내용설명도 물론 중요하지만, 각 참고서들의 핵심은 앞의 기본설명을 확실히... "
중1후반부부터의 수학선행	... 선행좀 진짜 제대로 알려주세요~ 참고로 저는 외고 준비하고 있어용~ 도와주세요!  쎈수학좋아요~~ㅋㅋ 난이도별로 나누어져있구요~ 기초문제들만풀어도 제학년가면 심화문제는 풀수는있을거에요^^ 저는 그랬다구요...
고1 수학과외 안늦었나요?	... 제가 다른 건 그냥 평범한데 특히 수학 성적이 완전 안 좋아요ㅠ 기초가 안 잡혀 있어요. 엄마가 과외라도 알아 보는 게 어떻겠냐고 하셔서.. 고민 중이거든요 근데 딱히 알아 보려 해도 어떻게 알아봐야 하나 싶어서요. 친구들한테... 
수학학원 보내려고 하는데여 화봉동 쪽도 좋아요	... 이여도 좋아요 우리 학생을 위한 학원 알아보시네요! 울산송정 소규모 정예학원 영수학원 교육팀장입니다. (한양수자인 앞에 있어요) 질문에 대한 답변 드릴게요. 어떤 학원에 다니건 누구에게 어떻게 배우느냐가 중요합니다. 공장에서... 
어떤 수학문제집이 좋아요?	저는 중2예요 2학기 수학이 제일 어렵다고해서..왜 쟤가... 좀  수학은 공부안하다가 하루아침에 되는건 아닌데 아직 중 2니까 가능성은 있네요^^ 저도 수학 중 2때부터... 집에와서 수학을 잡고 하루에 3시간정도 했거든요 제자랑같네여... 
숙명여고 근처 수학학원	숙명여고 근처에 내신 잘봐주고 잘나오는 수학학원 있으면 알려주세요ㅜㅜ기초만 조금 되고있어서 빡세더라도 잘 나오면 좋아요 좋은 수학학원 알려주세요ㅠㅠ 숙명여고 내신에 맞는 안녕하세요 ~ 목동에서 잘가르치고 학생... 
"풀리는 수학, 풀리 이거 좋아요?"	제곧내제곧내  좋습니다
저는 수학이 너무 좋아요......ㅡㅡ	전 수학이 아주 재미있어요 언어나 암기과목은 최악이져;; 제가 이번에... 문과수학만해서 사실 과탐하구 수학2는 하나도모르죠;; 그래서 그냥 인문계로... 추천해 드리고 싶습니다. 아니면 수학을 잘 하신다니 경영학도 괜찮을 것 같습니다.
수학정석.. 문제 좋아요?	... 수학정석 문제 좋죠 그러니까 많이들 풀고 하겠죠? 그치만 그것만 풀어서는 안되요 보통 모의고사를 잘보는 사람들은 서점에 나와있는 문제집을 거의 다 풀어보죠 제가 아는오빠는 일년에 문제집 30권을 풀었다고..-_-; 우선 자신에게... 
화명동 수학학원 잘가르쳐주면 좋아요~	... 그런데 수학에 자신이 없어용ㅜㅜ 그래서 슈학학원을 다니려고 하는데 어디로 다녀야 할지 수학학원 결정을... 알려주셔용*^^*  수학학원은 시스템이 중요하지 않습니다.... 김정현수학입니다. 초등 고학년부터 고등부까지 연계성을... 
어떤 수학문제집이 좋아요?	저는 중2예요 2학기 수학이 제일 어렵다고해서..왜 쟤가 갑자기 공부를 할려는지는 잘모르는데;; 쟤 성적이 32예요..... 중학교 수학은 공식만알아도 풀수있는 문제가 많거든요. 혹시 시험이 좀 어려우시다면 뒤에어려운 문제도 꼭... 
수학과외 영어과외 초중고학생들 재밌게 가르치면 좋아... 	... 너무 어두운 느낌의 수업보다는 밝고 재밌는 과외선생님과 수업하면 아이들이 좋아할 것 같네요 세남매를 키우다보니 좀 재밌고 유쾌하게 수업 하길 원하는데 혹시 가능하실까요??  안녕하세요 불당동 부근 수학과외 영어과외... 
제발 도와주세요 심장이너무안좋아요	... 심장이너무안좋아요 오늘 수학여행으로 에버랜드갔는데 3일째였거든요 수학여행가기전에도 허리다리가안좋았는데 3일연속으로 하루종일 걸엇어요 근데 에버랜드에서 너무 뛰고 걷고하다보니 심장이 너무 안좋아요 배고파서... 
예비고2 수학!!! 과외가 좋아요 학원이 좋아요?	... 수학을 너무 못하고 힘들어하고 있습니다. 지금 학원을... 그래도 계속 질문하니까 죄송하긴 하지만 저도 수학... 성질급한 수학을 배우고 있는 것 같아요. 이제 한달... 더구나 님의 수준에서 수학 독학은 더욱 무리이기 때문에 혼자서... 
제가 학원 수학쌤을 좋아 하거든요..	... 학원 수학쌤을 좋아해요.. 좋아 하는데요... 선생님이 26 섯 이고요... 저는 14살 이거든요... 휴.... ㅠ.ㅠ 그런데요.. 제는 띠동갑이랑 결혼이 하고 싶어요. 어린나이데 이쌤이랑 하면 영원히 갈수 있따는 생각이 들구요.. 너무 좋거든요..... 
두산 중2수학책이좋아여 디딤돌중2 수학책이좋아여?	두산 중2수학책이좋아여 디딤돌중2 수학책이좋아여?  뭐 개인의 취향이 있는거지만.. 전 개인적으로 디딤돌 출판사꺼 좋아해요 편집도 괜찮고.. 어짜피 문제야 다 거기서 거기니까 서점가서 보시구 님이 더 맘에 드는거 푸시는게 꾸준히... 
평촌학원가 수학학원 어디가 좋아요..?	... 평촌 학원가에 수학학원 어디가 좋을까요...? 내신을 잡아줄수 있는... 첨삭도 해주시면 더 없이 좋겠구요..^^ 학원 추천 부탁드립니다~ 위드영수학원... 좋았어요. 위드영수학원 추천드려요. 영어 관도 따로있다고하더라고요. 
"6학년 수학 문제 12문제만 풀어주세요,,"	"... 반 전체의 사분의 일은 국어를 좋아하고, 그 나머지의 삼분의 이는 수학을 좋아 하고 그나머지의 육분의 일은 영어를 좋아합니다. 국어, 수학,영어 중에서 아무것도 좋아하지 안는 학생은 몇명입니까.? - 한 변의 길이가 24m인... "
부모님이 수학쌤인게 더 좋아요 아님 유명한... 	부모님이 수학쌤인게 더 좋아요 아님 유명한 치과의사인게 더 좋나요 그렇게 되면 물론 좋지만은 수학 선생님이 나 치과 의사가 아니더라도 마음이 따뜻한 부모님 이면 좋겠습니다 
고1 수학 공부법	"... 굳이 오답노트 하는데 문제 다 적고 풀이 다 적고 막 문제, 해설지 가위로 오려붙혀서 새로 오답노트 문제집 그러지마시고 상위권 아닌이상 시간낭비 너무 심하며 님이 모르는 부분만 공부하시는게 좋아요 ,또 수학 유형... "
수학 문제집 질문!	... 쎈 수학도 좋아보이던데.. 고 1 수학 심화책 추천좀요 ! 수학의 정석은 수학의 기본개념을 배우는 책이구요^^ 심화 문제집으로는 쎈도 좋아요^^ 난이도 별로 문제들이 많이 있거든요^^ 시험이 어렵다고 기본을 모르면 힘드니까... 정석은... 
수학여행 드라이기	"... 그러나 만약 여러분이 드라이기를 사용하시고 싶으시다면, 여러분들끼리 함께 사용하시는 것이 좋아요. 다만, 수학여행에서는 모든 것이 공유하고 사용하는 것이 일반적이므로, 다른 학생들과 협력해서 사용하는 것이 좋아요. 전체... "
중3인데요 수학학원 가는게 싫고 여름	... 할건하고 혼자 잘 하는편이고 수학 성적도 좋아요 학원을 안다니면 이해안가는거 해결 못하고 그러나요?  안녕하세요 질문자님 영수 개별맞춤전문과외 교육담당 위드쌤이라고 해요 ^^ 전혀 그렇지 않습니다 오히려 인강이나 특히나... 
초등수학 개념 알기 쉬운 방법	... 다 듣고 50일 수학 이어서 들으면 좋아요. 고등학생을 위한 중등수학 총정리거든요. 그리고 수학은 학생의 스타일과 현재 상태를 명확히 알고 선택을 하셔야 해요. 인강은 학생들이 이해를 했는지 선생님이 확인을 못합니다. 그래서... 
영어학원 수학학원 청송마을 쪽도 좋고 공부방도 좋아요	... 수학학원 보내볼까 하는데 주변에 잘하는곳이 있을까요?  고창마을 청솔마을 고창마을학원 고창마을수학학원... 국영수학원 영수학원 소수학원 일대일학원 1:1학원 코칭 푸른솔초 운유초 장기중학교 장기중 푸른솔중학교 푸른솔중... 
중랑구 신내동에서 초등수학은 어디가	중랑구 신내동에서 초등수학은 어디가 좋아요?  중랑구 신내동에서 초등수학은 어디가 좋아요? 수학의숲수림학원과 수학전문익스클래스학원이 후기가 좋아요 상담받고 결정하시길 바래요
중2 수학문제집	... 수학이 어려우시다면 개념부터잡는 '올리드' 좋아요 또 시험준비하신다면 '특급기출 수학' 도 좋아요 다 얇고 어려운 문제가 많이없어서 술술 풀리실거예요 저도 많이 도움됬어요ㅎㅎ좀 어러운거는 '적중100수학' 어려워요 그리고... 
'수학의 정석'어떤게 좋아요???	... 쎈수학 10-가 3개만하셔도 퍼펙트. (EBS사셔도 ~~ 좋아요) 영어 단어장 능률COVA어원편? 60日인가 그거 좋아요 영어단어 왠만큼 아시는 분이라면 ↑좋고요 아니라면 우선순위영단어 중학교과정 다 하세요 독해 리딩튜터가 젤 난듯;;... 
두산 중2수학책이좋아여 디딤돌중2 수학책이좋아여?	두산 중2수학책이좋아여 디딤돌중2 수학책이좋아여?  두산 보다 디딤돌이.. 정리도 잘 되어있고.. 가끔 어려운 문제도 있고.. 더 유익한 문제집인것 같습니다. 만약 구입하시려면 디딤돌 수학책을 사시는 게 좋을것 같네요.
"사고력 수학 학원 어디가 좋아요? 와이즈만, 소마... "	... 1년정도하니깐 스스로 학습이 가능하고 무엇보다 학습태도가 너무 좋아졌어요 스스로 학습이 가능해서 직장 갔다와도 걱정이 안된답니다. 그리고 수학을 너무 좋아해서 저는 대만족이예요. 전 초들6학년까지 꼭 보낼생각입니다.
군자동수학과외 어디가 좋아요? 초등 중등 고등	"... 중학교,고등학교 두아이 군자동수학과외 찾고있는데 너무 여러곳이 있는것 같아서 어떻게 선택을 해야할지 모르겠네요 ㅠㅠ 군자동수학과외 해보신 분들의 추천 받고 싶습니다. 안녕하세요^^ 8년동안 광진구에서 과외수업중인... "
혼자서 풀기 좋은 중2수학문제집	혼자서 풀기에 중2수학문제집 어떤 게 좋아요? 수학 공부는 해야 되는데 자신도 없고.. 그래서 일단 공부라도 해보자 하고 중2수학문제집 찾고는 있는데 또 막상 찾으니 어떤 게 좋을지도 모르겠고.. 혼자서 풀기에 괜찮은 거 있으면... 
문과 / 고등학교 수학 선생님	... 문과면…수학 선생님 되는 건 안되나요..?ㅠㅠㅠ 문과도 될 수 있다면 조금이라도 알려주세요…ㅠㅠㅠ 진짜진짜 작은 것도 좋아요..! 고등학교 수학 선생님 되는 방법 알고 계신거 다 알려주세요ㅠㅠㅠ  가장 보편적인 루트가 사범대... 
중1수학문제집 어떤게 좋아요?	중1수학문제집을 풀고있는데 어떤식으로 진행을해야 나한테... 저에게 맞는 중1수학문제집을 어떻게 찾을 수 있나요…? 안녕하세요 천재교육 문제집 지식파트너입니다. 중1수학... 체크체크수학을 추천드립니다 수학은 쉬운 개념부터... 
수학 초고수되는 방법좀용 ㅡㅡ;;;	수학을 좋아는하는데요;; 맘처럼 쉽게안풀리네요 원리를 이해해라고들 막하시는데 하는방법도 잘모르겠고;;; 좋아는하니까 투자는 마니할수있어용 잘하는법좀 갈켜주세요 저는.. 수학을 절때로 암기과목이라고 생각하지 않아요.. 저도... 
수학강사에 대한 질문인데요..	제가 우선 수학을 좋아 해서 강사를 하고 싶은데요.. 앞에 질문에서... 가능 하다고 말씀 하신거 같은데.. 고졸도 가능 한지 알아 보고 싶습니다.. 지금 수학 공부도 .. (독학으로.. 지만요..)하고 있고... 자신도 있습니다.. 초등학생말고... 
5호선 굽은다리역 좋은 수학학원 추천 부탁드려요	... 평소에 수학을 많이 좋아하시 않아서 수학에 흥미를 가지게 하고자 교구 수업하는 학원을 다니긴 했는데요 이제는 교과내용위주로 학습을 해야 할 것 같다는 생각이 듭니다. 이제 점점 학년이 올라가다보니 스스로 수학에 관심을... 
예비고1 수학선행학습관련;	... 글구.수학 인강 좋아염ㅋㅋ 아.그리고 이거 절때 광고아닌데요 저도 어제 인터넷 하다가 찾은건데 곰스쿨이라구요. 곰플레이어에서 만든 인강사이튼데.무료에요 ebs말고는 무료인강 없엇잖아요.근데 여기 강사님도 진짜 유명하고... 
중학생 수학문제집 뭐가 좋아요?	!!!수학문제집 !!!좋은데  이홍섭선생님의 기본서 개념원리 중학수학 추천합니다.. 설명과 문제가 적절하게 들어가 있어서 좋고 난이도도 쉬운것부터 어려운것까지 다 있습니다.
6학년 수학 문제	... 32명중 25%가 수학을 좋아 한다면 수학을 좋아하는 학생은 몇명 입니까? 4. 옷을 25%할인하여 33750원에 샀습니다. 할인하기 전의 가격은 얼마 입니까?---( ) 5.1800대4500을 간단한 자연수의 비로 나타 내시오---( ) 이것좀... 
수학의 신이 되는법	... 수학을 좋아 해야죠. 잘 생각해 보면 좋아하지 않는 것은 절대 최고가 될 수 없습니다. 문제를 열심히 푸는건 그 다음이죠... 흥미만 가지신다면 자기도 모르게 쉬는 시간엔 문제를 풀겁니다 ㅋㅋ 구체적인 방법이라면 역시 수학... 
영어100점맞기vs수학100점맞기 뭐가더좋아요?	시험볼때 영어100점맞기vs수학100점맞기 뭐가더좋아요?  영어
수학 고민이요ㅠㅠ	... 수학을 좋아합니다..그마음 변치않을려고 노력합니다. 근데 요세 성적이 계속 나빠집니다...단원평가는 항상100점을 맞는데 중간 기말등 이런 중요한시험은 장난아니예요.예습은 많이 하는편이고 복습도 선생님 말씀도 들으며... 
수학 문제	... 어떻게 해야 수학을 좋아 하게 되고 잘하게 될까요..? 전 왠지 공부랑은 안맞는것 같다는 생각을 자주 해요...지금 같은 상태에서 수학을 좋아 하고 점수 올르게 할 방법은 없나요? 1:1 과외는 어떨까요??내공 30걸테니 좋은 답변 기대... 
수학을 좋아하는 방법?	"... 영어나, 국어는 그렇지 안거든요ㅠㅠ 수학을 좋아 할수 있는 방법 어디 없나요-_-a 우선 중 3에 올라갔다니, 빨리 수학이 좋아져야겠네요. 그렇지 않으면 점점 더 수학이 싫어지게 되고 고등학교에 가면 기초가 부실해서 더욱... "
수학 완전 정복 하는 방법좀	... 예체능 좋아!! 수학 쌞 뷁..이런겁니다 아우 씨바 저 월래 수학만 빼면 공부잘하는 얘로 인정돼는데 이 병신사바 수학이 절 그냥 안냅둬요..ㅠㅠ.. 수학잘하는 방법이라도 있으신분!!!! 알려주세요 내공有 안녕하세요^_^** 님은 저랑... 
"중등 과학, 수학 문제집 추천 부탁"	... 또 어려운 문제를 원하신다면 같은 출판사의 특작수학이 좋아요. 다른 문제집을 원하시면 특작수학 문제집의 제일 앞페이지에 수준별로 정리되있 는 거 있으니까 그거 고르면 되고.. 만약에요 개념 설명이 잘 되있고 문제도 있는걸... 
"고3 영어, 수학 기출문제집 추천해주세요,,, 설명... "	... 기출문제와 함께 해설도 자세히 나와서 공부하기에 좋아요. 수학으로는 수학의 바이블 시리즈가 괜찮아요. 단계별로 구성되어 있어서 어느 정도 수준마다 맞는 책을 선택할 수 있어요. 둘 다 해설이 자세한 편이라 기출문제를 풀면서... 
예비고1 수학 노베이스 문제집인강 추천	... 저것들 말고도 ebs인강과 문제집 병행할 수 있는 걸로 추천 부탁드려요 수학 아예 노베이스입니다 ㅜㅜ!  아예 노베리스면 정승제 선생님 수학 50일 좋아요 책이나 강의 목록 보고 다 알면 중학수학총정리 봐도 좋을 것 같아요
일본의 수학 난이도가 어느정도인가요?	... 수학을 좋아 하긴한데 갑자기 일본어 공부하면서 일본 수학 난이도는 어느정도 일까라는 생각이 갑자기 들었습니다. 그래서 이글을쓰는데 읽어주시고 답변해주시면 감사하겠습니다. 1. 일본 고등학교 1학년은 우리나라 몇학년껄... 
김포 걸포동 영어과외 수학과외 북변동 까지 좋아요... 	"... 김포 걸포동 영어,수학 전문과외모임 코칭샘입니다. 20년 노하우와 교수방법을 가진 경력샘들의 1:1전문과외쌤 모임입니다. 교육청 등록 전문과외샘으로 대학생 과외나 일시적 교사완는 차별화된 교육으로 책임감을 가지고 최선을... "
예비중 수학 인터넷 강의좀 추천해주세요 !	"... 제가 수학 인터넷강의를 보려고 하는데 어떤걸 해야할지 잘 모르겠어요,, 제가 수학을 안좋아 하는편이지만? 상위권 입니다.. 추천 부탁 드려요 !  안녕하세요 수박씨 닷컴 멘토입니다. 내년에 중학생이 되시는군요~ 중학교부터는 학습... "
중학교 수학 참고서 어떤 교재가 좋아요	"... 그런데 수학을 너무 좋아하고 더욱 잘하고 싶은데 어떤 교재를 사야할지 몰라서요...... 추천좀해주세요.  우선요, 학교에서 중상위 권이시라면, 에이급 출판사의 ""에이급 수학""이 상당히 좋을 것 같아요. 가격은 8000원 이구요, 과정은... "
수학만 잘하면 어떤대학가는게 좋나요??	... 근데 수학만은..좋아 하기두 하지만.. 점수도 잘나와요.. 그래서 그런데 .. 수학만 잘할경우.. 어떤대학에서 어느학과로 가야하나요?? 제 꿈은.. 수학선생님되는게 꿈이거든요............ 수학만으로 대학을 가려면 올림피아드... 
복대동 중등 수학과외 영어과외 없으면 가경동도 좋아요... 	중학생 입니다 복대동 아니면 가경동 수학이랑 영어과외... 수학학원 가경동영어학원 가경동초등학생학원 가경동중학생학원 가경동고등학생학원 가경동초등수학학원 가경동초등영어학원 가경동초등국어학원 가경동중학생수학학원... 
수학여행경주로가면좋아요?	"수학여행경주로가면좋아요?  사람마다 다 달른데 , 저는 처음에는 좋았다가 맨날걸어서 다리에 알만 배기고왔어요 . 유적지 탐색 ?유익하긴한데 체력이딸려요 ㅋㅋㅋㅋㅋㅋㅋㅋ제 친군 체력이 좋아서 날아다니더라고요 저는 별로 ..... "
중학교 1학년 수학 문제집	예비 중인데 중학교 1학년 수학 문제집 뭐 사면 좋아요?  안녕하세요. 천재교육 문제집 서포터즈입니다. 예비 중학생으로 중학교 1학년 수학 문제집을 찾고 계신 것 같은데 체크체크 베이직이 도 움이 될 것 같아 답변드립니다. 체크체크... 
화명동 수학학원 잘가르쳐주면 좋아요~	"... 그런데 수학에 자신이 없어용ㅜㅜ 그래서 슈학학원을 다니려고 하는데 어디로 다녀야 할지 수학학원 결정을... 영어 수학 학원 찾으신다구요 ? 저희 학습코칭학원은 전국의 144개 지점 있습니다, 가까운 지점으로 안내를 해드릴수... "
대치동 수학학원 추천	... 저는 사람 적은 곳이 좋구요..되도록이면 체계적으로 가르쳐주는 학원이 좋아요 특히 제가 시간표를 짜서 스스로 자신에게 부족한 부분을 채워줄 수 있는곳 을 좀 알려주세요 이윤재 수학학원 이라는 곳 좋아요? 블루스카이는 좋나요?... 
수학이 즐거우면 수학을 잘 할 수 있을까요	안녕하세요 중3여학생입니다 저는 정말 수학이 즐거워요 답을 풀어나가는 매우 많은 과정과 매우 다른 증명법이 진짜 너무 흥미롭고 재밌어요 근데 제가 수학을 좋아만 하지 못해요 중3일학기 중간고사에서 40점을 맞아본 경험도 있고... 
수학에 대한 고민..	... 수학을 좋아 한다고 하셨죠?? 그럼 하루에 몇문제씩 풀어보세요. 수학을 좋아하시니 질리진 않으실겁니다. 많이 푸는것 만큼 좋은건 없다고 생각합니다. 제가 그렇게 해서 살았거든요.. 개인적인 말이지만 학원을 끊어서 이번 수학... 
급함>>> 중곡동 수학 단과 학원 어디가 좋아요??	"... 사이구요, 수학이 다른과목에비해 점수가 좀 많이 떨어져 수학때문에 평균 다 깍아 먹어서ㅜㅜㅜㅜ 수학 단과를... 중곡동에서 수학단과 괜찮은 학원좀 추천해주세요^ -^*  고려학원 아시죠? 그 학원 앞에 보시면... "
수학책 추천 (문제집×)	... 근데 보통은 쉬운 게 많아서ㅠㅠ 어려운 걸 원하시면 다른 거 사시는 게 좋아요! 2) 수학으로 보는 세상 선생님께서 말하셨던... 내용도 이해 잘되게 설명 잘해놨고 생각보다 문제도 쉬웠어요! 어려운 문제도 가끔씩은 나오더라고요! 이... 
수학의정석이좋아요?개념원리가좋아요?(내공많음)	... 제가 중학생때는 수학잘하는편은아니고 항상90점은 넘엇거든요..가끔 88점..; 선배얘기들 들어보면 수학거의다... 문제는 수학의 정석이냐 개념원리냐 이게 문제인데요..... 그리고 제가 혼자서 수학공부할꺼거든요.!! 제가 원래... 
수학에 대해서 질문이요..	"... 마지막으로 님이 수학을 좋아 한다니... 어려운 문제를 풀거나, 응용에 성공해 답을 구했을 때의 기쁨을 누구보다 잘 아시리라 생각됩니다. 연습보다 더 좋은 방법은 없겠죠. 문제집 3~4권을 준비해 놓은후에 비슷한 유형의 문제들을... "
뭉치수학왕 수학 초등전집 괜찮나요??	초등 저학년 아들 초등전집으로 뭉치수학왕 생각하고 있어요 여기저기 검색한 결과 뭉치수학왕이 좋아보이더라고요 그런데 요즘 나온 초등전집이라서 주위 친구들은 아무도 안 읽고 있어서 진실된 후기가 궁금하네요 광고말고 실제... 
수학만 잘하면 어떤대학가는게 좋나요??	"... 보면..사범대 수학교육과와는 달리, 수학과에는 정말 수학에만 몰두하고 순수하게 수학을 좋아해서 온 학생들도 있거든요. (물론, 일부는 수학과에서 '교직이수'라는 걸 해서 수학교사가 되기 위한 길을 준비하기도 합니다. 그걸... "
수학 해설 보기	... 그런 수학적 호기심은 그냥 그런대로 두시고 하시던데로 하는게 좋아보이는데요? 수학성적에 악영향이 있어보일 수 없어요 틈나면 수학공부 하려는 사람 같군요 물론 체화해내야 하겠지만요 영단어는 영단어대로 수학은 수학대로... 
수학여자선생님이좋아요...ㅠㅠ	저는 중학교2여자인데요 1학기초반땐관심없던 수학쌤이 나무좋아요ㅠㅠ 갑자기 관심이왜 생겼나면 수학여행갓을때 저희학교가 계곡으로 갔을때가 있었는데 제가 수영복을 너무 야하게 입고 와서 그 쌤이 저한테 온갖 셔츠랑 그런걸로... 
수학 학원 어디가 좋아여????? 답변좀 부탁 ㅠㅠ	니마 수학 학원 어디가 좋아여 답변 질문 좀 부탁~~~~~  엄마가 가장 좋은 선생님입니다. 선생이 엄마뻘되는 구몬학습 추천드립니다.
인내심이정말많은사람!!그리고 수학을 허버좋아하능사람	아..연립방정식 문제인데요.. 너무어려워서요 ....... 음 문제 푸시면서 설명 써주면정말 감사드리겠어요^^ 우선가감법으로 푸는건데요 4x+7y=-13 5x+2y=4 이거.....설명부탁드릴께용.... 대입법으로는 x+y=11 3x-2y=2 이것도........... 
안양 고1 수학과외 영어과외 구해봅니다	"... 지금 1학기 내신성적이 너무 안좋아 안양수학과외 안양영어과외 생각중입니다 너무 비싸면 엄마가 안된다고 하는데 어디로 알아보는게 좋을까요?  안양과외 사시는 곳과 학년, 학습수준을 알아야하는데 알 지 못해 전체적으로... "
안양 고1 수학과외 영어과외 구해봅니다	... 지금 1학기 내신성적이 너무 안좋아 안양수학과외 안양영어과외 생각중입니다 너무 비싸면 엄마가 안된다고 하는데 어디로 알아보는게 좋을까요?  안양수학과외 안양영어과외 알려주시면 돼요 저는 대학생과외를 별로 권해드리진... 
예비 고1 수학 총정리 문제집 추천	"... 고등 수학이 어렵다면, 중등 수학에서 개념빵꾸난 곳이 있다는 것이고, 고등수학이 어렵기 때문에 중등 수학을 빠르게 점검해서 빠진부분 채워넣으세요~ ebs 무료인강 정승제쌤 50일 수학 기초닦기 아주 좋아요. 마찬가지로 중등수학... "
노량진 수학단과 이왕열 좋아요?	"이번 방학때 노량진에 수학 단과 다닐건데 비상에듀에 이왕열이란 사람 잘 가르켜요? 예비고1이 들을꺼는 몇개 없든데... 선택의 폭이 없음ㅋㅋㅋ 이미 들어본 사람 있으면 어떤지 답변좀 해주세요.  저는 현강은 안들어봤고요, 이왕열꺼... "
마곡엠밸리 영어학원 수학학원 공부방같은곳도 좋아요!	... 우리친구 수학 영어 학원을 찾고 계시네요! 개별 진도와 개별 지도로 수업하는 소수정예 수업은 어떨까요? 고민되신다면 상담 받아보시고 결정해주셔도 좋아요. ^^ 재재쌤 학원은 소수정예의 둥지형 수업 방식으로 지도하고... 
중학교 1학년 수학 문제집	예비 중인데 중학교 1학년 수학 문제집 뭐 사면 좋아요?  안녕하세요! 비상교육 온리원 멘토입니다. 예비중1이라고 하신다면 [한권으로 시작하기] 문제집을 선택하시는 것이 좋으리라 생각합니다. [한권으로 시작하기]의... 
불당동 수학학원 영어학원 찾아요 쌍용동 근처도 좋아요... 	제목그대로입니다 불당동수학학원 불당동영어학원 불당동국어학원 찾아요 아이들이 고등학생 중학생인데 학원알아보기가 힘드네요 쌍용동수학학원 쌍용동영어학원 쌍용동국어학원 다좋아요 불당동영수학원 쌍용동영수학원... 
"예비고1 수학, 국어 문제집 추천해주세요.(+공부법도... "	... 이거풀고 또 다른문제집 풀꺼라 어떤문제집을 이어서 풀면 좋을지도 추천해주면 좋아요.  안녕하세요. 고1 수학 내신을 대비하기 위해 난이도 별로 문제를 풀어보시는 것은 어떠신가요? 고1 수학의 개념을 완벽하게 잡고 난이도 별... 
"수학 정교사 2급 자격증을 받고 싶습니다,"	현재 공대 4년제를 졸업했습니다 하지만 수학이 좋아 수학 공부도 하고 정교사 2급 자격증도 받고 싶습니다 수학교육과 편입은 TO가 나지 않아 힘들다고들 하시는데 수학과에 편입해서 교직이수를 할 수는 없을까요? 1학년 마치고... 
중학교 2학년되는데 중계동 수학 단과학원 어디가 좋아... 	수학단과 학원을 꾸준히 다니려고 하는데 첨이라 잘 몰라서여. 수학 단과 잘 가르치는 학원과 학원비 등등... 궁금한게 넘 많아여.] 도움 부탁드립니다.....^*^. 정준교 수학학원... 학생수도 아마 중계동 수학학원 중에서 제일 많은 걸로... 
고1 수학문제집과 수학에 관하여 =_=	... 그냥 학원에서 많이쓰고 좋다는거좀 추천해주세요 참고로 저는 수학 최저 50점 최고 80점이구요 수학은 좋아는하지만 잘하지는 못합니다 개념 이해를 하고 문제를 많이 푸는게 낫겠죠. 그런데 문제를 많이 풀어도 시험직전보다는... 
원주 무실동 수학학원 영어 공부방도 좋아요	초등이랑 중등아이인데 아이들 집에서만하다가 학원이나 공부방 보내보려구요ㅠㅠ 주공쪽인데 인근에 없을까해요ㅠ  영어는 처음에 무조건 단어를 많이 외워야 합니다. 단어를 알아야 끼워맞추던 뭐던 할 수 있기 때문이에요.... 
경제학과 가려면 수학을 꼭 잘해야 하나요??	... 전 수학을 좋아만하고.. 잘하지는 못하는데..ㅠ 그리고 조선대 경제학과 좋나요? 저도 이번에 수능을 본 학생입니다. 저의 질문에 대해서 의견을 내주셨기에 저도 한마디 올리려구요. 우선 경영학과나 경제학과나 어느 정도 수학능력을... 
3학년 수학	... 세 사람이 각각 좋아하는 과목을 쓰시오 영이 : 나는 수학을 좋아 합니다 철수 : 나는 수학을 좋아하지 않습니다 수연 : 나는 체육을 좋아합니다  하나씩 제거해 보면서 가면 됩니다. 한사람이 거짓말을 했으므로 첫번째 영이가 거짓말... 
[내공] 수학 학원 어디가 좋아요?	"... 수학 학원을 다니려고 합니다... 단순히 내신을 위해서 다니는 학원이 아닌, 심화된 내용과 경시대회 정도의 문제를 배울 수 있는 학원이었으면 좋겠는데요... 여기 주변에는 그런 학원이 없는 것 같아서요... 저는 경기도 구리시에... "
김포 걸포동 영어과외 수학과외 북변동 까지 좋아요... 	걸포동과외 알아보고 있는데 주변에 괜찮은 분이 계신다면 바로 시작하고 싶어요 아이도 안하려고 하는아이가 아닌데 여태까지는 학습공백이 조금 길어진 상태에요 이번 중간고사도 마음처럼 되질 않았고 시험을 아이도 욕심내어... 
안좋아요. 영어과외 수학과외 통해서 내신 올려볼려고... 	... 내신위주로 공부를 하고 있는데 아무래도 영어과외 수학과외 통해서 내신 올려볼려 해요. 도와주세요.  고2면 정말 많은 고민이 되실것같습니다 과외라면 충분히 올릴수있습니다. 현재 무료 레벨테스트를 진행하고있기때문에... 
"예비고1 수학, 국어 문제집 추천해주세요.(+공부법도... "	"... 이거풀고 또 다른문제집 풀꺼라 어떤문제집을 이어서 풀면 좋을지도 추천해주면 좋아요.  안녕하세요 천재교육 문제집 서포터즈 입니다 중학교 3학년이신데 고등학교 1학년 수학과목, 국어과목을 공부하기 위해 난이도가 쉽고 개념... "
초등 2 수학전집 추천해주세요	아이가 수학을 좋아하지는 않지만 그래도 책을 아주 좋아해서 수학 개념을 책으로 읽히면 보겠다 싶어요. 2학는 덧셈 뺄셈 간단한 구구단이지만 앞으로 나올 개념들 충실하면서 교과연계되는 수학 전집 있으면 추천부탁드립니다.... 
수학잘하는방법 초4 (내공50)	... 워낙 수학을 좋아 하긴 했지만.. 중학교때 이후 고1 수학의 고난이도에 발을 헛디뎠습니다. 수학이란 과목.. 분명 암기할 공식이 많은것 확실합니다. 하지만 초등학교 4학년이기에 지금부터 천천히 배울수 있는 기본 공식은 문제를 많이... 
공통수학도 정석을 봐야할까요?	... 질문자님이 그래도 포기보단 다시 기본을 하려는 맘가짐 좋아요 좋아.. 수학잘하려면.. 끈기가 필요해요.. 어떤 문제 모른다고 좀생각하다 답보고 으음... 아하.. 이런식 절대 수학실력 오르지 못해요.. 최소 2-3일동안 이궁리 저궁리... 
대구 침산동 수학학원 영어학원 침산네거리 근처면 좋아요	... 친구 수학 영어 수업을 찾고 계시네요! 개별 진도와 개별 지도로 수업하는 소수정예 수업으로 진행하고 있으니 고민되신다면 상담 받아보시고 결정해주셔도 좋아요. ^^ 소수정예로 지도하고 있어서 학생들 개개인의 진도에... 
수학 잘 하는 법	수학 잘 하는 법 알려주세요 곱하기 암산도 제대로 못하고 이해력 기억력 다 안 좋아요 어떻게 하면 수학 잘하고 친구들하고 문제 같이 풀까요 맨날 수학시간엔 화장실 가는척 애들 수학풀때 빠져있어요  수학같은 경우는 공식을 무조건... 
수학경시대회에 대해서 궁금한게 있습니다.	... 선생님들이 그래도 수학 좋아한다고 기대는 한 것 같은데 올해는 글렀어도 내년은 좀 시험봐서 잘보고 싶거든요. 그래서 지금 질문을 드리겠습니다. 1. 제가 수학을 좋아만 했지 수학 공부를 너무 소홀이 한건가요? 하면 그래도... 
중학교수학마스터	... 쎈수학이 좋아요 쎈수학은 문제가 난이도 별로 나눠져 있구요 또 유형별로 나눠져 있어요 문제도 많아서 다양한 유형을 익히기에도 좋아요 7-가에는 일차방정식이 나오는데요 ax=b라는 형태에요 ax가 있는 부분을 좌변이라고 하고요... 
대구 침산동 수학학원 영어학원 침산네거리 근처면 좋아요	침산동수학학원 찾으려고 해요. 발품을 팔아보려고는... 안녕하세요 반갑습니다 현재 영어학원 수학학원을 찾을 수... 대구침산동수학학원 대구침산동영어학원 에서 그렇다면... 침산동수학학원 침산동영어학원 은 학생들을 개개인별로... 
수학 학원이나 과외하면 좋아여?	... 그리고 님이 뭐 수학등이 할만하다면야 독서실을 하는게 ... 어떠실지요 ? 뭐 아니면 1대1 가외도 추천합니다 . 결론적으로 독서실을가서 혼자 공부한다 !!! 입니다 . 독서실가면 주위에 에들 다 공부하니깐 자기도 막 하고싶어지거든요... 
수학학원 다니고싶어요 부천상동 까지도 신중동 좋아요	좋은학원이 있다면 꼭 다니고싶어요 부천중동쪽이나 상동까지도 좋아요 아이들은 고1 그리고 중2 학생인데 보내보려고해요 아이들 숙제도 많이내주고 관리도 잘되었으면 해요 영어 그리고 수학 레벨이 조금 많이 낮아서 이해 부탁해요... 
뉴런 수학 문제집을 살껀데 상이 좋아요 하가 좋아요??	제가 이번에 중1문제집 수학은 뉴런으로 살려고 생각하고 있는데 난이도가 상이 좋나요 하가좋나요?? 이비에스 뉴런... 상이 1학기이고 하가 2학기입니다. 난이도를 말하는 것이 아닙니다. 따라서 님은 수학1(상)을 구입하셔야 합니다. 
제가 학원 수학쌤을 좋아 하거든요..	... 학원 수학쌤을 좋아해요.. 좋아 하는데요... 선생님이 26 섯 이고요... 저는 14살 이거든요... 휴.... ㅠ.ㅠ 그런데요.. 제는 띠동갑이랑 결혼이 하고 싶어요. 어린나이데 이쌤이랑 하면 영원히 갈수 있따는 생각이 들구요.. 너무 좋거든요.... 
대구 침산동 수학학원 영어학원 침산네거리 근처면 좋아요	침산동수학학원 찾으려고 해요. 발품을 팔아보려고는... 안녕하세요 반갑습니다 현재 영어학원 수학학원을 찾을 수... 대구침산동수학학원 대구침산동영어학원 에서 그렇다면... 침산동수학학원 침산동영어학원 은 학생들을 개개인별로... 
중1수학문제집추천	"... 네, 좋아요.하지만 저는 뭔가 빨리 질려서< 3.다른 과목 문제집 추천좀요..(국,수,,사,과,영,기가) 국어는 한끝-한권으로 끝내는 국어(통합편)이나 나비-나만의비법이 좋아요 수학은 쎈수학,RPM이 좋아요. 유형별로 문제를 잡을수... "
뉴런 수학 문제집을 살껀데 상이 좋아요 하가 좋아요??	제가 이번에 중1문제집 수학은 뉴런으로 살려고 생각하고 있는데 난이도가 상이 좋나요 하가좋나요?? 이비에스 뉴런... 상이 1학기이고 하가 2학기입니다. 난이도를 말하는 것이 아닙니다. 따라서 님은 수학1(상)을 구입하셔야 합니다. 
수학 학원이나 과외하면 좋아여?	... 그리고 님이 뭐 수학등이 할만하다면야 독서실을 하는게 ... 어떠실지요 ? 뭐 아니면 1대1 가외도 추천합니다 . 결론적으로 독서실을가서 혼자 공부한다 !!! 입니다 . 독서실가면 주위에 에들 다 공부하니깐 자기도 막 하고싶어지거든요... 
[중3]수학완자VS개념원리중학수학+SSEN수학... 	"... 예를들어 중3완자수학 ~~이래서 좋아요,~~이래서 안좋아요, ~~해서 비추,~~해서강추 등등 개념원리 ~~이래서 좋아요,~~이래서 안좋아요, ~~해서 비추,~~해서강추 등등 쎈수학 ~~이래서 좋아요,~~이래서 안좋아요, ~~해서 비추,~~해서강추 등등... "
수학학원 다니고싶어요 부천상동 까지도 신중동 좋아요	좋은학원이 있다면 꼭 다니고싶어요 부천중동쪽이나 상동까지도 좋아요 아이들은 고1 그리고 중2 학생인데 보내보려고해요 아이들 숙제도 많이내주고 관리도 잘되었으면 해요 영어 그리고 수학 레벨이 조금 많이 낮아서 이해 부탁해요... 
강동구 수학.과학 주말에하는 학원 있나요	... (수학만 이라도 좋아요 ㅜㅜ 왠만하면 여자쌤이 좋은데 아니여도 되고요구 그냥 좀 편안한 분위기면 좋을듯 합니다.)  안녕하세요~ 수학 수업중인 선생님 입니다!! 강동구 근처에 학원 찾고 있다고 하셔서 답변 남겨드려요!! 저희는... 
수학관련 책 질문!!	수학을 좋아하나 안좋아 긴가민가해 관력 책을 읽어 보려 합니다. 현제 진도는 중2 1학기 일차함수 부분 나가고 있고 중1 입니다 관련 책 추천 해주셨슴 좋겠습니다 아직 배운것이 이것뿐이라 책에 모르는 내용이 나오면 곤란합니다 ㅠ... 
수학 공부에 관한 질문!	... 공대 대학을 다니고 있습니다..ㅋ 일단 수학을 좋아 해야겠죠??ㅋ 저는 일단 좋은 선생님의 도움이 커서.. 적응하기에 편했습니다. 일단 수학 점수를 높이기 위해서는.. 이러케 하는것이 좋을듯 싶네요...^^ㅋ 중학교 문제집을 사서... 
제가 학원 수학쌤을 좋아 하거든요..	... 학원 수학쌤을 좋아해요.. 좋아 하는데요... 선생님이 26 섯 이고요... 저는 14살 이거든요... 휴.... ㅠ.ㅠ 그런데요.. 제는 띠동갑이랑 결혼이 하고 싶어요. 어린나이데 이쌤이랑 하면 영원히 갈수 있따는 생각이 들구요.. 너무 좋거든요.... 
수학학원 보내려고 하는데여 화봉동 쪽도 좋아요	안녕하세요 울산 송정영어학원 보내려고 하는데요 화봉고 1학년 친구이고 학원은 처음으로 다니려고 하고 있어요 송정수학학원 고등 내신 위주로 잘 가르치는 곳 아시는 분 알려주세요 화봉동 쪽 이여도 좋아요  울산 송정... 
수학 중2	수학공부 잘 하는 방법 좀 가르쳐주세요 잘하고싶어요 수학공부를 잘 하고싶다면 일단은 수학에 대한 흥미를 가져 보세요 그래야 수학을 더욱더 가까이 할게 될거에요 수학 선생님에 대해서 좋은 마음을 가지세요 그래야 수학이 좋아... 
대치동 수학학원 고등부요.	... 문과 수학강의 좋아요. 수업시간은 주2회 3시간씩하는 수업있고. 고3반은 주1회 3시간30분씩 수업하는 반 있어요. 1.2등급 위주로 강의해요. 대치동에서 쩌는 선생님들 많아요 영어랑 국어도 고3은 수능반 고 1.2는 내신반으로 있어요.... 
두산 중2수학책이좋아여 디딤돌중2 수학책이좋아여?	두산 중2수학책이좋아여 디딤돌중2 수학책이좋아여?  사람마다 다르겠죠 하지만 전 개인적으로 두산은 절대 비추입니다 문제가 조잡하달까... 많이 본 것도 같고... 전 디딤돌이랑 신사고 추천합니다 문제가 꽤 괜찮더라구요
수학 어떻게 해야 잘은 아니어도 이해하고 풀수... 	... 이번 방학에는 진짜 1학년 꺼라도 마스터 하고 싶어요 근데 하루 아침에 공부형 인간 되는게 힘들잖아요..제발 제발 저좀 도와주세요 그냥 따끔하게 한마디도 괜찮고 경험 있으신 분의 조언도 너무너무 좋아요 수학 학원 선생님이... 
고등수학문제집 추천좀여	... 문제를 많을걸 혐오해요 각 필요한문제들만 딱있는게 좋아요 수학 기초개념서 추천바랍니다 일단 고1것부터추천좀여 학년이 달라질수록 문제집이 좋은게있고 별로인게있다길래 안녕하세요 수학하는 남자입니다! 고등학교... 
수학 잘 하는 방법	"... 저는 수학을 좋아 해요. 그러나!! 수학을 잘 못합니다. 제가 수학을 잘 하는 것을 달느 친구들한테 보여 주고 싶어요.. 그러니, 수학 잘 하는 비법좀 알려 주세용!!. 그럼.. 3학년이라.....제 동생이랑 똑같네여 ㅎㅎ 저도 옛날엔 수학 조금... "
고1수학2학기꺼에대한것	... 제가 수학을좋아하는편이거든요 ;;;물론이과고요 내신도그럴저럭잘받는편인데 ;;영어하나가 미잇어가지고좀걱정이네요 .. 수학 내신은 100점맞고요...모의고사도한 50~60맞아요 .. 근데요 제가 요번방학동안2학기수학을할라고... 
예비고2데요 겨울방학때 수학을공부할려고하는데..	... 수학을 할려고해요..ㅜㅜ 수학을 좋아는 하는데.. 성적이 안나오네요. 얼마전까지 고1 이였는데.. 시간이 너무 빠르네요... 그래서 고1겨울 방학때.. 예비고2 수학을 예습을 할려고 합니다. 수학을 할려고하는데.. 어떻게 해야 할지... 
수학학원 가기싫어요 오떡하죠	어떡하죠 진짜 가기 싫어요 가도 이해도 안되고 졸리기만 하고 문제도 못 풀고 스트레스 받고 근데 영어학원은 좋아요 수학만 하...죽ㄱㅓ싶어요진짜 수학 진짜너무싫어요 학원 ㄱㅏ기싫다 어떡하죠 하죽과ㅓ싶어요 저도 그랬는데 결국... 
"노원쪽 수학, 영어학원 어디가 좋아요?"	"... 수학학원,영어학원추천해주세요.. 학원비도알면알려주시고요^^  윗분들이 대답하신 학원들이 요즘 외고입시로 많이들 다니시는 학원들입니다~ 집에서 가까운 곳으로 선택하시면 될 거 같은데 외고에 관련된 자료가... "
수학문제집 추천 좀 부탁드립니다!	"... 수학 너무 좋아요..) 내공 50!!  중위권 우공비,[체크체크(책이 두 권 있어요)] 중상위 정도로는 쎈,rpm 추천 드리고요 상위권으로 에이급수학,최상위 수학, 그 외에도 마플 교과서 등등이 좋아요! 전 주로 개념과 응용이 섞여있는거 다음... "
중학 수학 문제 급해요....	"우리중학교 1학년 전체 학생 390명 중에서,국어를 좋아하는 학생이 280명,수학을 좋아하는 학생이 210명 두 과목 다 좋아하지 않는 학생이 50명이다 수학만 좋아 하는 학생 수를 구하면? 1번 30명 2번 60명 3번 90명 4번 120명 5번... "
목동수학학원 어디가 좋아요?	지금 중딩때부터 1-2년간 다닌 학원이 있는데요 그냥 계속 비슷하게만 유지하고 있어서요... 성적올리고 싶은데 진짜 제대로된 학원 소개해주세요  백인대장 ㄱ
수학 방법좀	"... 심화문제집은 요즘 여러가지 많던데 제가 사용해본것중에는 고난도 수학이나, 에이급수학, 하이레벨등이 있는데 이중에서 문제수가 많아도 양호하시다면 에이급이나 하이레벨, 문제수 적절한걸 원하신다면 고난도 수학이 좋아요.... "
중1 수학 학원에 대해 질문 있습니다.	... 허나 수학은 좋아 합니다. 좋아하는 반면에 성적은 영 아니고요. 수학학원도 보내보고 개인 과외도 해 봤지만 샘들이 도중에 개인문제로 그만 두거나 너무 강압적이거나 해서 현재는 EBS로 공부를 하고 있는 중입니다. 질문의 요는... 
초등 5학년 1학기 수학 문제집 어떤게 좋아요?? 진짜... 	"초등 5학년 1학기 수학 문제집 어떤게 쓰기 좋아요?? 집짜 급해여 ㅠㅠㅠㅠ 내공 50드려여ㅠㅠ EBS만점왕,쎈,필란드수학,우등생 추천 해드릴게욥^^ "
중1수학문제집 어떤게 좋아요?	중1수학문제집을 풀고있는데 어떤식으로 진행을해야 나한테 맞고... 저에게 맞는 중1수학문제집을 어떻게 찾을 수 있나요…?  유투브에... 기초부터 중등수학을 그림으로 알려주는 영상 잃어버린 수학감각이 깨어나는..
수학학원 영어학원 급히 찾습니다.. (공부방도 좋아요)	... (영통)  안녕하세요~ 영통에서 학원 운영 중인 재재쌤입니다^^ 자녀분 수학 영어 학원을 찾고 계시네요! 개별 진도와 개별 지도로 수업하는 소수정예 수업은 어떨까요? 고민되신다면 상담 받아보시고 결정해주셔도 좋아요.... 
수학교수가되고싶은되요 도와주세요(내공20)	... 요즘 수학안좋아해서 수학 수없듣는 학생 없다던데;;; 그럼 자동으로 교수일 못한다던데.. 물론 명예도 있지만. 못 먹고 살면.. 걱정이;; ㅜㅜ 저 회사원 같은일 개인 적으로 싫어요. ㅜㅜ 에휴.. ==;; 수학교수라는거 미래에 각곽받는... 
6모 수학 3등급 공부법	"... 수학공부를 안하는 건 아닌데 그렇다고 열심히 하지도 않았던 터라 국수영 중에 수학 성적이 제일 안좋아요. 13,14번은 거의 손도 못대고 11,12번부터 당황하고 시간잡아먹다가 어버버 맞추는 경우가 허다합니다. 동네 학원에서 개념... "
대치동 수학학원 추천	... 저는 사람 적은 곳이 좋구요..되도록이면 체계적으로 가르쳐주는 학원이 좋아요 특히 제가 시간표를 짜서 스스로 자신에게 부족한 부분을 채워줄 수 있는곳 을 좀 알려주세요 이윤재 수학학원 이라는 곳 좋아요? 블루스카이는... 
입시미술하려는데 수학이 좋아요	... 미술을 하려니 수학을 포기해야할것 같고 수학을 포기 하려니 너무 해놓은것들이 아깝고.. 저도 공감 합니다! 제가 그랬거든요 .... 저는 일단 계산하는걸 너무 좋아했어요. 그러다 어느덧 고 2가 되었을때 슬슬 진로를 정해야 할... 
중1수학문제집 어떤게 좋아요?	중1수학문제집을 풀고있는데 어떤식으로 진행을해야 나한테 맞고 효율성이 좋은건지 전혀모르겠더라고요…..저에게 맞는 중1수학문제집을 어떻게 찾을 수 있나요…?  안녕하세요~ 수박씨닷컴 멘토입니다 ^^ 중1 수학문제... 
수학교사가 되려고 하눈데여!	... 제 학교 성적은 전교 10등안에서노는뎅..........이번중간고사는왕창떨어져서ㅜㅜㅋㅋ 저는 초등학교 때부터 수학을 좋아 했구요... 수학경시대회 나가서 상도 많이 받았어요! 지금도 물론 수학을 좋아하구요..... 학교 시험 수학은... 
아이가 수학은 싫어하나 컴퓨터는 좋아	아이가 수학은 싫어하나 컴퓨터는 좋아합니다. 컴퓨터 쪽으로 전공을 하려고 하면 수학도 잘 해야하나요??  수학 잘해야죠
수학이 너무 좋아요	"초 1 때 부터 싫었던 수학인데요 지금 초 5 거든요 근대 문제를 맞추니깐 그 희얼감때문인지 너무 기분이좋고 계속 풀고싶어요 이거 병인가요 ??!!!  아닐거에요~ㅎㅎ 수학에 재능이 있으신가봐요~ 수학 많이 푸세요, 도움 많이 되요~ 화이팅!!"
정보통계학에 필요한 수학	"... 1,2학기 둘다 C+받은걸로 암(전공인데 C+이면 출첵다하고 시험을 치긴했는데 시험성적이 바닥수준임) 그리고 통계학배울수록 수학잘할수록 좋아요... 교수님이 복수전공으로 같은부안에있는 응용수학과 추천했음 (수리과학부 안에... "
두산 중2수학책이좋아여 디딤돌중2 수학책이좋아여?	두산 중2수학책이좋아여 디딤돌중2 수학책이좋아여?  우선 교과서로는 둘다 상관없다고 봅니다. 어차피 같은내용이므로 그리고 문제집으로는 디딤돌을 권장합니다. 디딤돌의 개념원리 명작이죠 ㅋ 문제수준은 저조하지만 정리가 매우... 
영어학원 수학학원 청송마을 쪽도 좋고 공부방도 좋아요	아이 엄마에요 저는 청송마을 살고 있어요 그런데 고창마을 까지 공부방 또는 영어학원 수학학원 보내볼까 하는데... 고창마을영어학원 고창마을수학학원 청송마을영어학원 청송마을수학학원 까지 아이들이 교과목에 충실할수 있는... 
순천 연향동 근처 수학학원은 어디가 좋아요?(	"... 3.준스쿨과 올림수학중 어떤 곳이 더 좋아요? 4.근처에 좋은 학원 추천 부탁드려요~  저는 지금 준스쿨다니는데여; 확실히 준스쿨이좋아요. 그리고 제가 다니고잇어서하는말이아니라,, 문제도 꽤어려운것같구요. 무엇보다도... "
라이트 쎈 수학	"... 라이트쎈수학이 좋아보이긴 하던데... 혹시 공부해 보신 분들 계시면 답변 부탁드려요~~ 현재 고1 이신가요? 현재 고1부터 수학교육과정이 바뀐거 아시나요^^ 수1,수2 또한 말씀하신 라이트 쎈또한 원래 없던책인데. (쎈)은... "
수학공부 교재 추천	"... 숙제용도로 활용하기 좋아요! :: 그 외, 수학의 정석/ 풍산자/RPM/ 숨마쿰라우데/ 짱수학시리즈 수학은 중등 과정과 연계해서 보면 더 좋아서, 중등 문제집은 센시리즈/ 개념플러스유형/ 개념원리 참고하면 좋아요! ( 그 외, 수력충전... "
새 교육과정 수학 기본서는 뭐가 좋아요?	"내년 부터 고1 교육과정이 바뀐다는데, 수학 기본서로는 뭐가 좋은가요? 정석이나 개념원리 말고 조금 쉽게 공부할 수 있는 기본서 추천부탁드려요~ 저도 기본서를 찾으려고 서점에 갔다가 이번에 새롭게 나온 기본서를 발견했는데요.. 제... "
"영어, 수학문제집"	"... 신사고 수학도 좋아요 그렇게 어렵지는 않고 보통보다 조금 어려운수준 ㅎ 그리고, SSEN 수학이 조금 어려울수도 있는데 그정도는 꼭 해보시길 바래요 ㅎㅎ SSEN을 다 마스터하면, 한수위 같은 어려운 문제집도 풀어보세요 최상위권... "
수학은 싫은데 확률은 좋아요	왜 그런 걸까요? 수학에는 내가 싫어하는 분야도 있는데 그 중에 확률은 쉬워보이고 재미있고 실제삶에서 유용하게 적용되어서 그런 것 같습니다 궁금한점은 채택 후 1대1 질문 주세요 의견 알림이 뜨지 않아 의견은 잘 못봅니다 
수학이 너무 힘들어요	... 원래 중학교 수학 할 때는 제가 수학을 잘하고 좋아햇엇거든요. 나중에 수학과 들어가야지 할정도로 좋아하고 재밌어했엇는데.... 심화 과정 같은것도 풀어 보고 그랬거든요... 제가 이번에 학원 옮기면서 고등학교 꺼를 하게 됫거든요.... 
수학이 너무 좋아요	초 1 때 부터 싫었던 수학인데요 지금 초 5 거든요 근대 문제를 맞추니깐 그 희얼감때문인지 너무 기분이좋고 계속... 아니요!!병은 아닙니닿ㅎ 점점..가다가 수학이 ㅈ같은 순간이 있으실거에요^^ㅎ 열심히 하세요~!
수학교육과 vs 치기공과 (내공 有)	"... 수학을 좋아 하기는 합니다만.. 평생동안 수학을 하려니..ㅡ,.ㅡ 어디도 가면 좋을지 답변 좀 해주세요^^ 그이유도 말해주시면 very very thank you :D 상명대와 신구대를 잘몰라서 대학의 수준에따른 평은 드리기 힘들고요. 우선 과만... "
수학이 너무 힘들어요	... 원래 중학교 수학 할 때는 제가 수학을 잘하고 좋아햇엇거든요. 나중에 수학과 들어가야지 할정도로 좋아하고 재밌어했엇는데.... 심화 과정 같은것도 풀어 보고 그랬거든요... 제가 이번에 학원 옮기면서 고등학교 꺼를 하게... 
초등 수학 학습지 고민입니다.	"... 기적의수학법 좋아요^_^ 제가 사용하지는 않았지만( 알게 되었을때 이미 초6..,) 동생이 사용했고 주변 사람들도 많이 쓰는듯해요. 무엇보다 선생님께서 복사하셔서 주셨었어요. 음 그런데 저는 씽크빅을 추천하고 싶어요. 제 생각에는... "
부산 동래구에 수학전문학원 어디가 좋아요?	"부산 동래구에 수학전문학원을 다니려고 알아보고 있는데요, 어디가 괜찮은지... 롱최수학원도 좋은데...ㅋㅋㅋ 가격이 다른데보다 쫌비싸긴한데... 등록할수잇고 종합도잇는데 ㅋㅋㅋ 수학 과학전문이니까 도움이되실꺼같네요 ㅎㅎ "
수학여행 준비물	"... (충분 하게) 따뜻한 겉옷, 검은 비닐 봉지 4장 정도(멀미를 하지않아도 챙겨야해!)있으면 돼구..옷은 수학여행이니깐 일단 간편한게 좋구 넘 멋 부리면 안좋아, 수학여행엔 움직이는게 많기 때문에 옷이 불편하면 움직이기 불편하거든.."
어려운수학문제 풀면 머리가 좋아 지나요?	"어려운수학문제 풀면 머리가 좋아 지나요?  뇌세포가 늘어난데요.. 머리가 좋아지는건 맞아요.. 아이큐도 조금 올라간데요,, 쉬운문제를 풀면, 아이큐는 안올라간데요.. 어려운 문제 너무 많이 풀면, 머리에 두통이 생겨요..."
수학문제 푸는거 좋아하고 증명도 좋아	"수학문제 푸는거 좋아하고 증명도 좋아하지만 문제푸는걸 더 좋아하는데 수학과,수학교육과,생명공학과 중 어딜 가는게 좋을까요? 안녕하세요. 아무래도 이과 종류기 때문에 다 수학문제 풀 수있는 과니까 본인이 미래에 하고싶은 일이... "
김포 걸포동 영어과외 수학과외 북변동 까지 좋아요... 	걸포동과외 알아보고 있는데 주변에 괜찮은 분이 계신다면 바로 시작하고 싶어요 아이도 안하려고 하는아이가 아닌데 여태까지는 학습공백이 조금 길어진 상태에요 이번 중간고사도 마음처럼 되질 않았고 시험을 아이도 욕심내어... 
초3다닐 영어 수학학원 어디가 좋아요? 대형학원 말고요...	"... 분당 이매동 영어,수학 전문과외모임 코칭샘입니다. 20년 노하우와 교수방법을 가진 경력샘들의 1:1전문과외쌤 모임입니다. 교육청 등록 전문과외샘으로 대학생 과외나 일시적 교사완는 차별화된 교육으로 책임감을 가지고 최선을... "
수학과외 영어과외 초중고학생들 재밌게 가르치면 좋아... 	신불당수학과외 신불당영어과외 초중고학생들 재밌게 가르치시는 분과 수업을 하고싶어요! 너무 어두운 느낌의 수업보다는 밝고 재밌는 과외선생님과 수업하면 아이들이 좋아할 것 같네요 세남매를 키우다보니 좀 재밌고 유쾌하게 수업... 
비산삼성레미안 근처 수학학원 영어학원 어디가 좋아요?	"... 이제 예비 고1 이어서 학원을 알아보고 있는데 비산삼성레미안 수학학원 영어학원 어디가 좋나요??  안녕하세요... (한과목도 가능하며, 보통 영어, 수학 과목을 같이 많이 하고 있습니다.) 입시까지 전문 노하우있는 선생님들이... "
수학...!	수학... 좋아하긴 하는데..제가 공부를 안해서 답답해 하고 있거든요?(몰라서)ㅡㅡ^ 근데..친구들말도 그렇고..선생님 말도 그렇고.. 수학 교과서에 있는 문제만 다 풀줄 알아도 반은 맟춘다는데.. 그 반이 50점 이상이라는 뜻인가요?? 지금... 
수학교사가 되려고 하눈데여!	... 제 학교 성적은 전교 10등안에서노는뎅..........이번중간고사는왕창떨어져서ㅜㅜㅋㅋ 저는 초등학교 때부터 수학을 좋아 했구요... 수학경시대회 나가서 상도 많이 받았어요! 지금도 물론 수학을 좋아하구요..... 학교 시험 수학은 항상... 
예비 중3 수학멘토분구해여~~~~	... 제가 수학을 좋아 하지만 수학은 응용만 하면 어려운 문제가 나오기 때문에 항상 신중히 생각합니다. 그러는데도 불구하고 안풀리는것이 있어서 그러는데 제가 이메일로 문제를 보내면 알려주실 수학멘토분을 구해여.. 기간은... 
{30}대치동 수학학원 추천이요 내공30 내공올인~	... 대치동에 개념의힘 이란 수학학원 좋아요? 질문2. 개념의힘에 대해 설명해주세요 질문3. 다른 학원 추천요~( 페르마나 외고전문 학원 말고 고등부중심인데 추천해주세요) 학원 추천 하실떄 전화번호랑 그 학원이 어떤학원인지... 
급해여 ㅠㅠㅠ 고1 수학	유치원교사와 관련한 수학!!!!!!! 특히 다항식의연산들!!!!!! 그리고 다른 것도 좋아요!! 최대한 많이 알려주시면 감사하겠습니다!! 예신관리나 이럴 때 쓰일 거 같은데 어떻게 쓰이는지 자세하게 알려즈세요 ㅠㅠ!! 유치원 교사와... 
저는 수학이 너무 좋아요......ㅡㅡ	... 이제와서 이과 공부할려니 시간이 부족할것같구요.. 궁금한것은요.. 인문계과 중에 이과계통쪽으로 연결된 과는 모가있을까요?^^  어째서 수학을 좋아하시는분이 문과를 갑니까 -_- 수학잘하면 과학도 잘하던데 그러면 완전 이과구만은...
인내심이정말많은사람!!그리고 수학을 허버좋아하능사람	아..연립방정식 문제인데요.. 너무어려워서요 ....... 음 문제 푸시면서 설명 써주면정말 감사드리겠어요^^ 우선가감법으로 푸는건데요 4x+7y=-13 5x+2y=4 이거.....설명부탁드릴께용.... 대입법으로는 x+y=11... 
고1수학내신 올댓내신 기출좋아요?	"기출문제 찾고있는데 고1수학내신 올릴려구요. 학원은 안다니고 지금까지는... 기말이 중요하다길래 공부하려고 하는데 고1수학내신 점수따고 싶은데... 고1수학내신이 중요한 이유는 다른 과목에 비해서 고2, 고3까지 연계되는 부분이... "
대구 침산동 수학학원 영어학원 침산네거리 근처면 좋아요	침산동수학학원 찾으려고 해요. 발품을 팔아보려고는 하는데 마음에 들면 바로 하려구요 침산동영어학원 어디가... 침산동영수학원 침산동영어학원 침산월성동수학학원 침산중학교 인근학원 침산중등학원 영수학원은 학습 코칭을... 
수학 정석 구성?	"... 그래도 수1 이후 수2를 해주시는게 좋아요 그다음 수학 미분과적분/확률통계/이산수학 요 3녀석중 하나인데요. 현 수능 수학-가형 자연계 학생들의 시험범위가 수학1/수학2/미분과적분,확률통계,이산수학 중 택1 입니다. 거의 90%이상의... "
수학이 너무 힘들어요	... 원래 중학교 수학 할 때는 제가 수학을 잘하고 좋아햇엇거든요. 나중에 수학과 들어가야지 할정도로 좋아하고 재밌어했엇는데.... 심화 과정 같은것도 풀어 보고 그랬거든요... 제가 이번에 학원 옮기면서 고등학교 꺼를 하게... 
"대치동초등수학학원 중등선행, 고등선행 어디가 좋아요??"	황소수학학원을 가서 테스트를 봤는데 중등선행도 완벽히... 대치동초등수학학원을 너무 늦게 보내기 시작했나... 교과수학을 하려고 했는데 빠르면 초3부터 많이 보내는거... 대치동초등수학학원을 보내는 것이 더 나을거다고 추천을... 
중2 자녀가 수학 성적이 너무 안좋아요.	... 몰라도 수학성적이 너무 안좋더라구요. 그래서 부랴부랴 주변에 학원을 알아보고 해서 그래도 좀 좋다는 학원에... 것이 좋아보입니다. 아래에 링크를 남겨드릴테니 연락을 주신다면 상담 진행을 해드리겠습니다. https://open.kakao.com... 
수학 과학 진단평가 시험 범위가 어떻게 되나요?? 그리고... 	"... 그리고 진단평가 보면 (잘보면) 뭐가 좋아요?? 저도 진단평가 이번에 보는데 수학 과학 진단평가는 우수아들, 희망자 대상이라 문제 난이도가 보통보다는 높을거에요. 시험범위는 여태까지 배웠던 것들과, 약간 선행 문제가 될거에요.... "
수박씨 닷컴 수학 은지영 선생님	... 아니면 고등부 수학도 좋아요 ㅠㅠ 고등부 올라갈려면 1년반 남았지만 ... 그래도 은쌤이 뭐든 해주신다면 다 좋습니다 ㅠㅠㅠㅠㅠ 안녕하세요 은지영입니다^^ 울 제자♡ 쌤 그만두지 않았떠용ㅋㅋㅋ 지금 중2라면 앞으로 남은... 
중1 수학 문제풀이	중1 수학 문제풀이 해주세요 풀이과정도 설명해 주시면 좋아요! 중1 수학 문제풀이 해주세요 풀이과정도 설명해 주시면 좋아요! 
수학문제집	"... 센시리즈 - 개념원리: 고등 수학 개념 잡는데 가장 좋아요! 필수 개념서! 고3까지 활용가능! - 센시리즈: 유형별 정리가 쉽고 문제량 많아요! 숙제용도로 활용하기 좋아요! :: 그 외, 수학의 정석/ 풍산자/RPM/ 숨마쿰라우데/ 짱수학시리즈 "
고1 수학문제집과 수학에 관하여 =_=	"... 그냥 학원에서 많이쓰고 좋다는거좀 추천해주세요 참고로 저는 수학 최저 50점 최고 80점이구요 수학은 좋아는하지만 잘하지는 못합니다 개념도 이해하고 문제도 많이풀면 좋습니다만, 그럴 시간이없으시다면.. 개념을 먼저 확실히... "
수학과외 영어과외 초중고학생들 재밌게 가르치면 좋아... 	신불당수학과외 신불당영어과외 초중고학생들 재밌게 가르치시는 분과 수업을 하고싶어요! 너무 어두운 느낌의 수업보다는 밝고 재밌는 과외선생님과 수업하면 아이들이 좋아할 것 같네요 세남매를 키우다보니 좀 재밌고... 
수학 문제집 추천이요 고1	"... 쎈수학도 좋아요. 근데 이문제집은 문제가 너무 많아서 풀다가 지쳐서 공부하기 싫어 질수도 있어요. 그리고 교과서는 기본이구요. 님이 말한 수학의 바이블은 너무 쉬워요. 고1에게 수학문제집 추천하라면, 수학의 정석, 개념원리... "
수학여행때 백팩이좋아요? 캐리어가좋아요?... 	수학여행때 백팩이좋아요? 캐리어가좋아요? 에버랜드로가고 백팩은이미있어용  수학여행때 백팩이좋아요? 캐리어가좋아요? 에버랜드로가고 백팩은이미있어용 안녕하세요. 앤플린 캐리어 입니다. 간편한 짐 정도로 가신다면... 
저 진짜 수학학원이..	... 좋고요 세상에서 제일좋아요 이상한가요ㅜㅜ 진심이에요 1. 전혀 이상하지 않습니다. 수학을 좋아하는 사람들은 어려운 문제를 풀고나면 해냈다. 는 것 때문에 희열을 느낀다. 고 합니다. 2. 공부를 하는 진짜 맛이다. 고 생각합니다. 
고2 이과생 수학 기초가너무 부족한데	"... 사실 저는 수학을 좋아 하긴하는데.. 그동안 수학을 포기해서그런지 기초가 많이 부족한 것 같아요 성적은 반타작이구요,그동안 수학공부도 제대로 안한것같아요. 다른애들은 가외다 학원이다 거기다가 문제집 3권은 기본으로 풀고.... "
대성마이맥에서 국어 수학 어떤 쌤이 좋아요??	"노베상태에 5등급이었습니다 대성마이맥선생님들을 제가 잘 몰라서 추천 좀 해주세요  학생의 스타일과 현재 상태를 명확히 알고 선택을 하셔야 해요. 공부를 하는데에는 독학, 인강, 학원, 개인과외가 있죠. 독학이라는것도... "
수학시험 30점..많이 심각한가요?	"... 질문???? Q.성적 잘 오르는방법(실제 후기도 좋아요) Q.수학 문제집 추천! (기초부터 시작해서 추천부탁 드려요!),(강의 추천도 좋아욥) Q.수학에 유용한 꿀팁? 알려주시면 감사하겠습니다ㅠ 좀 심각한듯요.. 질문 1 답변. 수학은... "
수학관련 직업중 돈 많이 버는 직업	... 그건 그런거구요 전 하여튼 수학이 좋아요 나중에 수학관련 직업을 하고 싶은데 처음에는 수학교수나 수학교사 또는 학원수학강사 등을 하고 싶었는데; 평생을 가르치는 일만 하다보면 정말 짜증날것 같다는 생각이 들어요 그리고 전... 
초등 수학 어떤브랜드가 좋아요???	"디딤돌이나 왕수학, 올림수학 ...주변에서 이런 것들 많이 하더군요... 그중에서 어떤게 좋은가요?? 각 브랜드의... 디딤돌에서는 디딤돌 자체에서 만든 수준별교제로 배우거든요.ㅋ 초등수학이라서 잘 모르겠지만. 어쨋든 전 디딤돌입니당... "
두산 중2수학책이좋아여 디딤돌중2 수학책이좋아여?	두산 중2수학책이좋아여 디딤돌중2 수학책이좋아여?  둘다 각각의 장단점들이 있겠지만요.. 디딤돌은 설명이 매우 잘되어있어요~ 근데..문제는 다소어려운 부분이 이쓸꺼구요~ 두산은.. 쉬운 문제들로 되어있는거 같아요~
중1수학기말고사잘하는방법	... 저희 수학선생님이 딸한테 이거 시킨다고 하네요 ;ㅎㅎ 문제집은 DS수학 도 좋아요 ; ㅎㅎ 그런데 일반 서점 같은곳에서는 안판다는거 -_-;;; 솔찍히 중학생 첨 될때는 펜 많이 필요한줄 알고 얇은걸로 마니마니 샀어요; 뭐 지금은... 
"영어, 수학학원"	"... 전문이면 좋아요 5)수학만전문 영어만전문 잘가르치는곳도 괜찮습니다 비용도 써주시고요 선생님도 재미잇으면 좋아요 6)잘가르치는 영어,수학 온라인 강의 같은거 좀 추천 급합니다 안녕하세요^^ 9년동안 교육현장에서 학생들을... "
"수학은 잘못하는데 수학을 좋아하거든요,"	"... 근데 점수는 낮아도 수학 문제를 풀면서 발견하는 새로운것과 문제를 푼 후의 보람, 그리고 풀기전의 추론이 재밌어서 수학이 좋아요. 나중에 건축과를 다니고 싶은데 건축과에서 특히하고싶은건 설계부분도 하고싶고 인테리어까지... "
수학과제탐구 주제 질문	... 그래서 어려운 수학을 탐구하기보다는 평범한 난이도의 개념을 더 쉽게 이해하는 방법으로 탐구를 하는 것이 좋아보입니다. 수학은 기본적으로 기하학적인 부분과 대수적인 부분으로 나뉩니다. 아이들이 어려워하는 일은 머리속으로... 
고등수학.... 내공 100	... 솔직히 어렸을때부터 수학을못했는데 고등학교 와서 맛을..들였다고해야하나 ㅋㅋㅋ 그냥 수학이 너무 좋아요 수학풀고있으면 행복해요진짜 너무좋아요 설레고막 생각만해도 진짜 연애하는것처럼 좋아요 ㅠㅠ 다른건몰라도... 
수학잘하는 방법!!!!!!!!!!!!!	... 저희 선생님께서 말씀 하신건데 수학을 좋아하는것이 잘하는 것이래요 수학을 좋아하게 할려면 저희 선생님께서는 문제를 풀고 체점해서 맞았다는 표시(○) 이 표시를 보고 쾨감을 느꼈다나 뭐래나.. 그래서 수학을 좋아하게... 
수학문제 (거의 수수께끼?)	"... 그냥 풀어가면 좋을것같아서요 ㅎㅎ 문제 쓸게요 수 수학수 수학이학수 수학이좋이학수 수학이좋아좋이학수 이렇게 써준다음에 ""수학이좋아""는 모두몇개냐고 묻는문제에요.. 이거 풀어주시고 풀이과정도 써주세요~ 내공 30겁니다... "
수학만 공부하기 싫어요	... 다른 과목 다 좋아요 수학이랑 성격이 비슷한 과학도 좋아요 과학이 제 전과목 중에서 성적도 제일 좋고요 국어 사회 다 좋아요 수학 영어를 제외한 다른 과목들은 교과서만 훑어봐도 80 90점대는 나오는데 (영어는 제가 공부를... 
초3다닐 영어 수학학원 어디가 좋아요? 대형학원 말고요...	... 안말초 근처면 청구 한신아파트 근처에 SJ연세학원이라고 영어 수학 학원이 있어요 우리애들도 셔틀태워서 삼환 근처 대형학원 다니다 동네 학원으로 바꿨는데 애들 공부습관도 잡혔고 괜찮네요. 근처에 피아노 미술학원도 있어서... 
수학 학습지 어떤게 좋아요?	아이 수학 학습지를 해주려는데 구몬수학하고 한솔에서 새로 나온 수학 노피곰 중에 고민 되는데 어떤게 좋을까요?... 해보신 분들 말씀 좀 해주세요~ 초등 학교 1학년인 저희 집 아이가 지금껏 수학을 해온 건 집에서 하고 있는 연산의... 
고3 수학 질문..	"... 이에 대한 스트레스가 많았죠 수학을 좋아했지만, 잘하지는 못했던... 제가 추천드리는 것은, 무조건 다 몰아서 하실 생각은 피하셔야 한다는 겁니다. 올 한해는 수능이 가장 중요한 이벤트인만큼, 이 1년은 수능체제에 맞게... "
갑자기 찾아온 수학에 대한 스트레스 해소법좀..	... 정말 수학에 절망 하셨다가 지금은 수학이 좋아여~ 라고 외치시는분!! 제발 수학하고 친해질수 있는법을 알켜주세요.. 제 수학 수준은 진짜 초딩수준이구요..ㅜㅜ 초 4학년 꺼 부터 시작하면 될까여?? 제발 답변 부탁드려요!! 그리고... 
예비고2데요 겨울방학때 수학을공부할려고하는데..	... 수학을 할려고해요..ㅜㅜ 수학을 좋아는 하는데.. 성적이 안나오네요. 얼마전까지 고1 이였는데.. 시간이 너무 빠르네요... 그래서 고1겨울 방학때.. 예비고2 수학을 예습을 할려고 합니다. 수학을 할려고하는데.. 어떻게 해야 할지... 
김포 걸포동 영어과외 수학과외 북변동 까지 좋아요... 	걸포동과외 알아보고 있는데 주변에 괜찮은 분이 계신다면 바로 시작하고 싶어요 아이도 안하려고 하는아이가 아닌데 여태까지는 학습공백이 조금 길어진 상태에요 이번 중간고사도 마음처럼 되질 않았고 시험을 아이도 욕심내어... 
김포 걸포동 영어과외 수학과외 북변동 까지 좋아요... 	걸포동과외 알아보고 있는데 주변에 괜찮은 분이 계신다면 바로 시작하고 싶어요 아이도 안하려고 하는아이가 아닌데 여태까지는 학습공백이 조금 길어진 상태에요 이번 중간고사도 마음처럼 되질 않았고 시험을 아이도... 
김포 걸포동 영어과외 수학과외 북변동 까지 좋아요... 	걸포동과외 알아보고 있는데 주변에 괜찮은 분이 계신다면 바로 시작하고 싶어요 아이도 안하려고 하는아이가 아닌데 여태까지는 학습공백이 조금 길어진 상태에요 이번 중간고사도 마음처럼 되질 않았고 시험을 아이도 욕심내어... 
초등 수학전집 추천해주세요.	... 그나마 책 읽는건 좋아하는 아이라 겨울방학동안 수학전집을 읽어볼까하는데 수학전집 추천해주세요 책 읽는거 좋아하니 수학도 책으로 다가가서 재미나게 읽으면서 용어와 개념 익히면 더 좋을거 같아요~ 저는 성우출판사 뒤집기... 
수학정석 과 수학의바이블 ...	"... 학기중에는 해법 FEEL 수학이나 아름다운 수학도 좋아요... 무엇보다 중요한 건 님이 맘에 들고 재밌게 공부할 수 있는 걸 택하시는 거죠.. 서점에 가서 여러개 둘러보세요..맘에 드는 게 분명히 있을 겁니다... 참, 신사고 수학은 조금... "
수학 개못하는데	... ㅠㅠㅠㅠ 틀렸을때 너무 쪽팔리고 한심해서 멘탈이 와사삭 나가는데 극복하는 법 알려주세요  남의 시선은 신경쓰지 마시고 자신만의 공부 패턴을 파악 해서 푸시는게 좋아요.그리고 수학학원 다닌다고 다 잘하는건 아니에요.
수학학원이 너무 않좋아요	수학학원이 너무 안좋아요 책에 나와있는 내용 읽어주고 문제푸는것만 반복해요 선행학습도 잘 못알려주고 칠판이 아닌 말로만 설명하고….6개월동안 다녔는데 날린 느낌이에요 충격받은건 반 5명중에 저만 중2고 나머지는... 
대치동 수학학원 추천요~ 내공5 내공다건다	... 대치동에 개념의힘 이란 수학학원 좋아요? 질문2. 개념의힘에 대해 설명해주세요 질문3. 다른 학원 추천요~( 페르마나 외고전문 학원 말고 고등부중심인데 추천해주세요) 학원 추천 하실떄 전화번호랑 그 학원이 어떤학원인지... 
중학교수학이요.ㅠㅠ..	... 5.중학교가서도 어려운 수학도 좋아할수있는방법 중1수학 잘하는 방법좀 알려주세요.. 빨리부탁드려요^^ 내공냠냠등 뭐 밥이나 먹어라.. 이런 관련없는 말들은 신고합니다.-.- 중1수학 고수님들 부탁드려요.~~~~ 적지만내공도드립니다... 
수학 질문	... 그리고 숨마 중간 정도 진도 나갔을 때 교과서 연습문제를 병행하면 더 좋아요 잊어버리기 전에 다시 한번 기억 더듬고 다지기가 됩니다. 개념편 마치면 이어서 쎈수학으로 유형다지기 좋아요. 쎈수학은 2번 풀어도 좋은 것 같아요~ 
수학경시대회준비하려는데	"대구에서 열리는 수학경시대회거든요,, 중1 1학기꺼만 친데요,, 앞으로 23일밖에 안 남았는데 기출 문제집 뭐 고를지 고민이에요,, 고난도수학이 좋아여?아님 에이급수학이좋아여?? 문제집 추천 좀 해주세요  실력이 어느정도 있어... "
이관데 수학을못하고 성적이 안좋아요	... 1학년때 수학성적은 5등급정도나왔습니다 ;;... 3월모의고사에서 수학12점 언어66 과학40점대[대충] 외국어 20몇점[찍어서] 이정도 나옵니다 고1겨울방학때 수학과외를 했었는데 수학과외하면서 많이 혼나면서 해가지고... 
수학관련 직업중 돈 많이 버는 직업	... 그건 그런거구요 전 하여튼 수학이 좋아요 나중에 수학관련 직업을 하고 싶은데 처음에는 수학교수나 수학교사 또는 학원수학강사 등을 하고 싶었는데; 평생을 가르치는 일만 하다보면 정말 짜증날것 같다는 생각이 들어요 그리고 전... 
전요. 수학을 제일 좋아하는데요..	"... (그런데 숙제를 안한 날에는 정말 싫지요..--;) 그리고, 수학을 좋아하는것은 쑥쓰러운것이 아니랍니다. 되려 자랑할것이지요. 님 주위의 친구분들이 수학에 자신이 없어서 그런가봐요 님한테 그런말을 하게..^^; "
고3 문과 수학 기초 잡는 인강	... 대학에서 어느정도의 영어 등급을 요구하는지 꼭 확인해보세요. 거기에 맞추어서 현실적인 학습 목표를 정하시는게 좋아보입니다. 수학에도 투자할 시간이 부족한 상황이니까요. 열심히 공부하시고 더 궁금하신게 있다면 질문주세요~ 
마곡엠밸리 영어학원 수학학원 공부방같은곳도 좋아요!	... 마곡엠밸리영어학원 마곡엠밸리수학학원 찾고 있어요 실력이 좋은곳이 있을까요.. 잘하는곳으로 가고싶네요... 영어수학학원 찾고 계신가요? 저희 학원은 소수정예 그룹형식으로 1:1 맞춤 진도수업으로 지도하고 있습니다. 개인별... 
올림수학vs왕수학	... 왕수학 안좋아요... 저두 몇달 다니고 끊었어요 올림수학이 좋아요 올림수학은 그냥 친구말로 들었는대요^^ 재가 5학년때 왕수학은 평균이 80점 나오고 올림수학 다닐때는 평균 92인가?? 어쨌든 90점 넘었어요 왕수학 다니시지 마시구... 
수학 잘하는 방법	... 그리고 지금 연산문제를 잡아두지 않으면 나중에 고등학교와서 계산실수로 아깝게 문제를 틀리기도 해서 (이것도경험담 ㅎㅎ..) 계산실수는 미리 잡아두는 게 좋아 혹시 수학노트 쓰니? 문제집은 어떤 거 풀어? 연산이 약하면... 
수학과외추천받아요~온라인 과외도 좋아요!	... 뭐든 좋으니 수학과외추천 부탁드려요~고1입니다!  수학과외추천 관련문의 주셨는데 혹시 자녀분의 현재 수학 관련 이해도라던가 하는 부분 고려가 되셨는지 부터 체크하시구요. 방학기간인데 사실 이 시기가 상당히 중요합니다.... 
수학학원 가기싫어요 오떡하죠	어떡하죠 진짜 가기 싫어요 가도 이해도 안되고 졸리기만 하고 문제도 못 풀고 스트레스 받고 근데 영어학원은 좋아요 수학만 하...죽ㄱㅓ싶어요진짜 수학 진짜너무싫어요 학원 ㄱㅏ기싫다 어떡하죠 하죽과ㅓ싶어요  수학은 뭐...... 
수학음악영화 찾아주세요!	"수학과 관련된 음악영화가 있을까요?? 음악과 수학이 둘다 들어간 영화였으면 좋겠어요! 고등학생이 보기좋은 영화로요! 정 안된다면 수학영화도 좋아요ㅠㅠ  질문자님 수학에 관련된 영화 추천드립니다,^^"
수학에 재미 붙이게 하는 방법	... 수학상식이 풍부하고 수학적 창의 사고력 실력이 늘어나면 자신감이 생기기 게되어서 아주 수학 이 좋아 질수 있습니다. 또한 수학 시험이나 기말고사 등 시험에서는 일단 교과서에 있는 내용을 언제나 복습하고 중요한것은 줄치고... 
고1 수학	수학이 너무 어려워요ㅜㅜ 고1 이해하기 쉬운 수학 문제집이나 인강 알려주세여  수학의 바이블 문제집 쉬워서 무난하게 기초잡기 좋아요! 아니면 수학의 왕도 문제집과 강의 병행하면서 공부해도 좋을 듯 해요.
"수학의정석 ,개념원리 둘중 어떤게 좋아요?"	저는 중3인 학생인데 10-가를 혼자 독학하려고 하는데 개념원리 수학의 정석중에 어떤게 더 좋아요? 9-나는 다 끝내서 하려고 하는데 어떤게 더 좋아요?  제 경험 상 혼자 공부하기에는 수학의 정석이 낫습니다. (현재 고1 이고 약간의... 
"내공최대/ 미래직업, 수학교육학과, 외국"	중학교때 까지만 해도 제 꿈은 예술쪽이었고 고등학교 올라와서 수학이 너무 좋아 수학선생님을 꿈으로 정해 고려대 수학교육과 아니면 경북대 수학교육과를 목표로 하고있었습니다. 그러나 고등학교를 다니면서 많은 수학선생님을... 
심리교육과 수학 관련 직업	... 아니면 심리와 수학만 접목되어도 좋아요 내공 50 드리겠습니다 심리학을 공부할 때 심리통계라는게 있거든요 그게 수학입니다. 심리학을 공부하셔서 최소 석사를 하시고 심리학개론 과 심리통계를 강의하여 대학원 코칭을 하는... 
용산 수학과외 영어과외 어떻게 찾아보면 좋아요?	... 용산수학과외 용산영어과외 구해보고 있습니다 도움주실 샘 계실까요?  용산수학과외 용산영어과외는... 검증이 되어있는 신뢰할 수 있는 모임을 통해 용산수학과외 용산영어 과외선생님를 구하는 것이 좋은 방법이 될 수 있습니다.
초등 5학년 1학기 수학 문제집 어떤게 좋아요?? 진짜... 	초등 5학년 1학기 수학 문제집 어떤게 쓰기 좋아요?? 집짜 급해여 ㅠㅠㅠㅠ 내공 50드려여ㅠㅠ  수학 실력이 많이 늘고 싶으시다면 쎈?쓰는거 추천드립니다.
올림피아드 수학문제집이 좋아여 아뉨 3000제가 좋아여?	"... 그렇게 하는 사람만이 수학하는 재미를 제대로 알 수 있게 될 것이며, 그러다보면 수학 점수도 점 점 더 좋아지게 될 것이다. 제 2 단계: 공식 암기 공식이란 정리의 일종으로서 선배 수학자들이 천재적인 머리를 사용하여 그것이... "
6학년 수학문제집 추천	"... 출판사는 지학사이구요, 어려운 걸 원하신다면 상상편이 낫겠네요. (경시대회 문제가 있어요.) 해법수학은.. 그냥 내신용으로 간단히 풀어보는 용이 낫겠네요. 좀 수준 높은 걸 원하신다면 쎈수학이 좋아요.^^; "
인터넷수학강의 어디가 좋아요? 에효~	인터넷으로 수학강의를 들으려고 하는데요 저는 고1인데요. 요즘 수학성적이 영.... 중간고사도 망치고..ㅜ.ㅜ 학교에서 pmp로 강의라도 들어야 겠다는 생각이.. 제 주위 친구들도 그런것 같고..해서.. 뭐 현재 강남구청도 들어봤고... 
수학 상에 대해서	... 아니면 중3-2 까지 배우고 수학 상 들어가야되나요? 중딩꺼 다하구 고등가세영. 뭐가됐든 고딩되기 전까지 수하까지 끝내놓으시는 게 좋아요. 수학은 학원 다니시는 거 추천드려요. 
6학년 수학문제집 추천좀	... 큐브 수학도 좋아요 . 간단하면서 여러가지 수학문제가 다양하구요 또 실력. 심화 . 기본으로 나뉘어서 자기 수준에 맞는 것을 골라서 할 수도 있구요. 아하 왕수학! 도 괜찮은 듯 싶네요. 그건 해설도 간단하고 괜찮은데 . 답지에... 
수학여행..	... 경험담좀...수학여행이랑 남친같은거...둘다 말해주시면 좋아요^^ 수학여행은 뭐 그냥 원카드같은거 가져가서 친구들이랑 재밋게하면되구요 츄리닝바지에좀 신경쓰이더라구요 저는ㅋㅋ 사복입으시니까 옷에좀 신경... 
중1인데 수학성적이안좋아공부를시키고싶은데학원교육... 	"... 실제로 수학으로 많이 버거워하는 학생들이 많은데요, 제가 하고있는... 첫째로 처음부터 수학을 하세요. 처음이라면 연습문제부터 풀란소리인가? 절대... 수많은 사람들이 하는 오해중 하나가 바로 수학의 처음인데요. 수학의 처음은... "
수학만 공부하기 싫어요	... 다른 과목 다 좋아요 수학이랑 성격이 비슷한 과학도 좋아요 과학이 제 전과목 중에서 성적도 제일 좋고요 국어 사회 다 좋아요 수학 영어를 제외한 다른 과목들은 교과서만 훑어봐도 80 90점대는 나오는데 (영어는 제가 공부를... 
용산 수학과외 영어과외 어떻게 찾아보면 좋아요?	... 용산수학과외 용산영어과외 구해보고 있습니다 도움주실 샘 계실까요?... 용산 수학 영어 과외 찾으신다고해서 답변드립니다^^ 학교는 어디로 다니고... 영어 수학 국어 주요과목 뿐만 아니라 과탐 사탐 영어회화 토익 등 교육청에 정식... 
제주 노형동이나 연동 근처 수학학원 영어학원 있나요?... 	"... 영어,수학 찾기는 한데 자세한건 다른과목도 상담해봐야할듯해요 기초가 영부족하고 혼자서 공부도 안하려하네요..  추천 드립니다. https://blog.naver.com/gts_math 자세한 사항은 블로그에서 확인하세요. 편하게 문의 주세요. ^^"
고1수학내신 올댓내신 기출좋아요?	기출문제 찾고있는데 고1수학내신 올릴려구요. 학원은 안다니고 지금까지는... 기말이 중요하다길래 공부하려고 하는데 고1수학내신 점수따고 싶은데... 고1수학내신 1:1 질문 감사합니다 고1수학내신 관련해서는 답변이 어려운 점... 
세교 금암마을 수학학원 영어학원 질문이요	... 올라가기전 겨울방학동안 학원을 보내보려고 하는데 세교 금암마을 수학학원 영어학원 어디가 좋아요?? 추천 부탁드리겠습니다~~ 안녕하세요! 학부모님 걱정이 많으실것 같아요 세교 금암마을에서 영어학원 수학학원 국어학원 관심이... 
수학문제 질문이여 빠를수록 좋아요 ㅠㅠㅠ	"이거 음수가 24개래요 근데 그 후엔 어떻게 하는지 모르겄어요 풀이까지 해서 좀 알려주세요  모두 49개의 분수 중 양수 25개, 음수 24개이네요. 그러므로 모두 곱하면 양수가 될 것이고, 각 분모와 분자는 차례차례 약분되어... "
부산 동래구에 수학전문학원 어디가 좋아요?	"부산 동래구에 수학전문학원을 다니려고 알아보고 있는데요, 어디가 괜찮은지 잘 몰라서요, 학년은 고2구요... , 그쪽이면,,, 수학전문ICC가 좋을거 같은데요^^ 전화번호는 잘모르구요^^ 114에서,, 수학전문ICC요,,하면 걸어줄꺼에요^^"
수학여행 코디(내공100)	... (가방1개에 짐이 다들어가요??) 1.이뿌게 옷입는 방법!(☜이뿐코디요~또 악세사리같은건 어떻게 하면 좋아요?) 수학여행 가시는거니깐 귀엽게 입구가세요 악세사리는 불편할지는 모르겠지만 너무 화려하거나 큰거는 하지마시구요... 
수학의 정석과 문제집	... 수학을 잘하는 편은 아닌데 적당한 수준의 문제집 추천좀요  흠냐 흠냐 안녕하세요 현재 고1을 끝내가는 수학을 좋아 하는 한 학생입니다 먼서 수학 문제집은 자신한데 맞는것이 따로 있습니다 무조건 친구분들이 정석 개념유형 개념... 
"중3 영어, 수학 공부하는 법"	... (강의나 문제집 추천해줘도 좋아요) 그리고 수학은 문제만 많이 풀면된다는데 진짜 문제만 잔뜩 풀어보면 되나요?? 자세히 알려주세요.. 중3입니다 안녕하세요. 교육부 학교생활컨설턴트입니다. 학원을 다니다가 점수가 오르지 않아... 
대구 침산동 수학학원 영어학원 침산네거리 근처면 좋아요	"침산동수학학원 찾으려고 해요. 발품을 팔아보려고는 하는데 마음에 들면 바로 하려구요 침산동영어학원 어디가... 가장 중요한 것은 한번 학원에 방문을 하셔서, 수업방식이나 분위기를 직접 보시고 결정하시는 것이 좋아요... "
"수학 나형 기출문제집, 사설모고 추천해주세요-"	"... 뭐가 좋아요? 수학 나형 기출문제집 풀려고 하는데... 사설 모고는 어떤게 좋아요?  시중에 나와 있는 문제집은 많은데, 나에게 꼭 맞는 문제집은 그 중 무엇일까(...) 찾는 게 고민되시고 힘든 분들게 ""개인 맞춤형 디지털 문제집... "
수학 선행	... 중3여름방학이나 겨울방학때가 딱 좋습니다. 많이 나가면 좋죠. 그래도 고1 되기전에 수상은 다 잡아놓는게 좋아요 수학은 완벽한 개념과 연습만이 살길입니다. 몰아서 하지마시고 꾸준히 하셔야해요. 이건 모든과목에 포함되겠지만... 
고등학교 수학 세특 수학영화 추천	... 고등학교 수학 세특에 적을 거를 준비해오라하셔셔 수학 관련 영화를 보려고 하는데 수학 공식 많이 나오는 수학 영화 추천해주세요  페르마의 밀실 추천드립니다. 옛날영화긴 한데 수학 문제가 많이나와서 수학 세특쓰긴 좋아요.
수학 문제 잘푸는 법	"... 시험볼때도 다른거 다 좋은 데 수학만 안 좋아요,, 특히 분수문제인데요..암산력이랑, 이해력같은게 떨어져염.. 정리 1...........수학문제 잘 푸는 방법을 알려주세요.. 2...........빨리 푸는 방법을 알려주세요. 3...........암산력 기를 수... "
수학강사에 대한 질문인데요..	제가 우선 수학을 좋아 해서 강사를 하고 싶은데요.. 앞에 질문에서... 가능 하다고 말씀 하신거 같은데.. 고졸도 가능 한지 알아 보고 싶습니다.. 지금 수학 공부도 .. (독학으로.. 지만요..)하고 있고... 자신도 있습니다.. 초등학생말고... 
중1 수학 어떡하죠ㅠㅠ	"... 넘어가는게 좋아요! 수학은 이해를 못하면 한없이 어려워지는 과목이기때문에 처음부터 알고 넘어가는게 중요한것같아요! 기초부터 시작한ㄴ 문제집으로 해결의법칙 풀어보세요 해결의 법칙은 개념잡는게 필요하시다면 개념편, 이미... "
수학여행은 어떤여행인가요? 또 어디가 좋아요?	... 저희가 곧 수학여행을 가게 되는데 수학여행에서는 무엇무엇을 해요? 자유인가요? 좀 자세하게 알려주시면 감사하겠습니다. 또 장소는 어디가 좋아요? 외국이라든지 이런 어처구니 없는 말말고 확실히 추천좀 부탁드려요... 
수학여행질문이요^^	... 수학여행 옷코디와 장기자랑 옷코디좀 해주세요!!(사진첨부면 좋아요) 수학여행코디는첫째날에는 위에티는 맨투맨입으시구요 바지는배기.h라인치마입으시구 두번째날에는 체크남방이나 청남방에다가 위에는 가디건... 
제가초딩 6학년여자구요 시험마다 수학	... 되기 때문에 국어 문제집을 풀면서 독해능력을 조금 높이시는게 가장 좋아요! 중학수학 들어가면 거의 대부분이 문장제 문제이기 때문에 빨리 독해 능력을 높이시는게 좋아요!! 수학 화이팅 하세요!! (도움이 되섰다면 채택 부탁드려요!)
전주고등학생이다닐만한수학학원요	효자동근처면 좋아요 상산고 다니는데 수학이 힘드네요 실수도 너무 많고. 학교친구들이 워낙 잘하니 제가 힘이 많이 드네요 추천좀해주세요 http://naver.me/54ViJgb4 안녕하세요 수학학원 찾고계신데 저희 전주수학학원 서신수학학원... 
수학여행 가방싸기!~	... - 여름이 아니면 잠옷은 긴 잠옷이면 어떤 스타일이던 좋지 않을까 생각합니다. 수학여행시 잠옷은 어떻게 보면 수학여행의 최고의 포인트 이지요..^^ 저는 첫번째 스타일 좋아요..^^ 즐건 수학여행 되시구요. 멋진 추억 만드시길... 
고2 모의고사 수학	... 6월에 잘 볼 수 있다고 하던데 진짜로 고1 수학이랑 고2 수학이랑 연관이 안되나요...? 그럴리가요 인수분해를 비롯한 평행이동 대칭이동 개념 모두 들어가요. 다만 1학년보다는 좀 수월하지요 그래도 고1수학이 탄탄한게 좋아요 
수학문제집 추천!! 중1-가	"... 감을 잡을 수 없네용~~~~~~~~ 또, 추가로 중1 국어,사회, 과학 문제집 추천해주세요!!ㅠ 영어문제집두용!!ㅠ 그리고 수학 강의 잘 가르치시는 곳 아시면 좀 갈켜주세요..ㅠㅠ 그럼 내공 40드립니다...ㅠ 수학은 개념원리 중학수학이 좋아요... "
경주로가는수학여행 질문 ^.^;	... 7.옷은 몇벌 가져가면 좋아용? 수학여행 갔다오신분만 답변해주셨으면 좋겠네요 ^^ 경주로 수학여행 갔다오신분이시라면 더욱더 좋구요 : ) 글읽어주셔서 감사합니당 질문 빠르고 정확하게 해주시면 좋겠네요 내공 20이구용 +ㅁ... 
수학학원 가기싫어요 오떡하죠	어떡하죠 진짜 가기 싫어요 가도 이해도 안되고 졸리기만 하고 문제도 못 풀고 스트레스 받고 근데 영어학원은 좋아요 수학만 하...죽ㄱㅓ싶어요진짜 수학 진짜너무싫어요 학원 ㄱㅏ기싫다 어떡하죠 하죽과ㅓ싶어요  수학은 대학교가서도... 
수학음악영화 찾아주세요!	"... 정 안된다면 수학영화도 좋아요ㅠㅠ  페르마의 밀실 감독 루이스 피에드라이타, 로드리고 소페나 출연 루이스 호마르, 알레조 사우라스, 엘레나 발레스터로스, 샌티 밀란 개봉 미개봉 페르마의 밀실 어떠세용? 수학 영화에용... "
중2수학문제집추천[내공15]급해여	... 이홍섭선생님의 개념원리 중학수학이 좋아요. 저희 반에서도 이거 푸는 사람 꽤 있구요. 수학하면 이거 중학생들이 알아준다고 합니다. 저는 이거하고 투탑수학 플러스 유형특강 도 있어요. 이거 2개 괜찮더군요. 가격은 개념원리... 
수학문제 (거의 수수께끼?)	"... 그냥 풀어가면 좋을것같아서요 ㅎㅎ 문제 쓸게요 수 수학수 수학이학수 수학이좋이학수 수학이좋아좋이학수 이렇게 써준다음에 ""수학이좋아""는 모두몇개냐고 묻는문제에요.. 이거 풀어주시고 풀이과정도 써주세요~ 내공... "
비산삼성레미안 근처 수학학원 영어학원 어디가 좋아요?	"... 이제 예비 고1 이어서 학원을 알아보고 있는데 비산삼성레미안 수학학원 영어학원 어디가 좋나요??  비산동 소규모정예학원 교육팀장 Doit쌤입니다. 매번 남들이 좋다는 곳에 보내는데, 정작 학원을 다니고 성적이 올랐나요?... "
수학의바이블과 수학의 뿌리중 머가 좋아요?	"고2인데 수학을 잘하지는 못해요. 혼자서 공부하려고 했는데.. 어떤게 쉬울지 잘모르겠어요. 정석은 고1떄 풀었는데... 제 생각입니다만, 원리 이해는 둘다 비슷하다고 생각합니다. 하지만 수학의 뿌리가 문제 자체가 괜찮은것 같네요,."
옥계 영어학원 수학학원 괜찮은곳 가고싶어요 산동 좋아요	... 와 수학 여태까지 학습공백이 정말 길어서 다시... 영어학원 수학학원 국어학원 관심이 있으셔서 답변... 많이 고민도 되실텐데 이왕 영어학원 수학학원 하시는 것... 구미옥계초등학생영어학원 옥계초등학생수학학원 옥계공부방... 
이상하게 수학과목만 성적이 안좋아요..	... 재가 정말 수학을 좋아라 하는 때는.. 딱 지금쯤?아니 고입고사를 치룬다음같내요.. 저도 고입고사를 봐서 어떻게 인문계로 가게 돼었는데 그때부터 수학공부를 했습니다.. 물론 중학교꺼는 아님. 학원을가서 딱한달간(약간후회됨 더... 
재미난 초등수학전집 있을까요??	... 들여 읽히고 있는데 2학년 아이도 진짜 잘보고 있는 중이랍니다.. 초등교과와 연계되어 개념부터 심화까지 넘 잘잡아 주고 있어 초등 전학년은 뭉치수학왕과 같이 보내도 좋아요. 초등수학전집은 뭉치수학왕 완전 강추합니다. 
빨리 답변부탁해요 중1수학 풀이만이라도 좋아요	"연속한 세 자연수의 합이 96일 때, 가장 작은 자연수를 x라고 하여 방정식을 세워라. a,b두 물통에 물이 각각 48L,12L 들어 있다. A에서B로 몇 L의 물을 옮기면 A의 물이B의 물의 3배가 되겠는가? 십의 자리의 숫자가 4인 두... "
급합니다 풀이랑 같이 해주시면 더 좋아용!중 1 수학입... 	답은?빨리요!급합니다 풀이랑 같이 해주시면 더 좋아용!중 1 수학입니다 발그림 죄송하구요. 
경주수학여행가뉸데..// 궁금한점잇어영@@	... 않좋아요 ^^ 수학여행은 대부분.. 2장기자랑 조명 좋아요? 아니요.. 시설이 않좋아요.. 3숙소는 어떤가여? 좋아요 ^^ 완전좋아요 ^^ 4디카 핸드폰 등등 가져가두되나여? 잊어먹으면 책임 자기가 져야되니까 가져가지 마세요... 
(빨리답공부탁)4학년1학기수학문제집뭐가좋아요???	(저급해요)4학년1학기수학문제집뭐가좋나요??? 빨리답공부탁해여 저한테도움되고이해잘대는걸루여빨리부탁해요  요새 4학년 수학 문제집 광고 많이 하던데요?-_-@ 광고를 해서 그문제집을 밀어준다는것은 그 문제집이 많이 팔렸음을... 
눈높이 수학 하는게 좋을까요 ?	"... 올라요 그만큼 우선 열심히 하시는게 가장좋아요. 수학이 많이 어려우신다면 눈높이 한번해보시고요 눈높이수학은 어려운 문제보다 쉬운문제 위주로 되어있어서 처음에는 쉬울꺼에요 ㅎ 그럼 이만. 시험 잘보세요 저도 지금 중2 ,ㅎ "
"수학 나형 기출문제집, 사설모고 추천해주세요-"	"... 뭐가 좋아요? 수학 나형 기출문제집 풀려고 하는데... 사설 모고는 어떤게 좋아요?  수능수학 기출문제를 수록하고 있는 수능수학문제집 중에서 구성이 괜찮은 문제집을 풀어보고자 하신다면, 수학기출문제집 '자이스토리 고3 수학'을... "
용산 수학과외 영어과외 어떻게 찾아보면 좋아요?	... 용산수학과외 용산영어과외 구해보고 있습니다 도움주실 샘 계실까요?  안녕하세요! 용산구에서 영어/수학 전문과외 수업을 지도하고 있습니다. 과목별 기초를 확실하게 잡을 수 있고 응용 심화 유형까지 탄탄하게 대비할 수... 
고1 수학 상+경찰관련 도서	"고1 수학 상 내용이 들어간 책 추천해주세요 범죄나 경찰 심리 수사관련한 책이면 좋아요 내일 까지 제발 부탁드려요 고1 수학 상 내용이 들어간 책으로 범죄나 경찰 심리 수사와 관련된 책을 찾고 계시다면, 다음 책들을 추천드립니다.... "
중3이 읽을만한 수학책	... 비슷한거 쓰는게 수행이에요 중3-1 과정이 들어가있는 수학책 좀 추천해주세여 ㅠㅠ 빠르게 읽을 수 있는 뭐..재밌는 책..?도 좋아요  아래 읽고 독후감 쓴건데 도움이 되실거에요 ~ 중학생들이 수학으로 보물을... 
"수학, 과학 관련 책 추천"	"... 과학이 생명과학이나 치과에 관련되면 더 좋아요..! 최대한 빨리요!!!! 수학과 과학을 모두 다루는 추천 책 중에서는 ""생명과학의 수학""이라는 책이 있습니다. 이 책은 생명과학에서 필요한 수학 지식을 다루며, 미적분, 확률, 통계 등의... "
저는 수학이 너무 좋아요......ㅡㅡ	"전 수학이 아주 재미있어요 언어나 암기과목은 최악이져;; 제가 이번에 재수하거든요,, 근데 문과에요 고등학교때부터 문과수학만해서 사실 과탐하구 수학2는 하나도모르죠;;... "
고1 수학 세특	"... 들어가면 좋아요 한두문장정도만 써주세요  안녕하세요. 답변드립니다. 내공100고1 수학 세특에 대해 멘토 역할로 참여한 적이 있다면, 아래와 같은 내용을 포함하여 내일까지 써오시면 좋습니다. 1. 희망 과는 화학공학과 입니다. 2.... "
예비중1 수학 문제지 추천!!	... 개념+유형+심화 한꺼번에 있는 수학책도 좋아요!! 그리고 rpm이랑 쎈중에 뭐가 더 좋을까요? 쎈은 (하) 가 좋나요?? 안그럼 (상) 이 더 좋나요?? 상 이랑 하 무슨 차이 인가요? 상이 더 좋나요?? 하가 더 좋나요?? 알피엠이랑 쎈은 목적이... 
"영어, 수학학원"	"... 전문이면 좋아요 5)수학만전문 영어만전문 잘가르치는곳도 괜찮습니다 비용도 써주시고요 선생님도 재미잇으면 좋아요 6)잘가르치는 영어,수학 온라인 강의 같은거 좀 추천 급합니다  안녕하세요. 2019. 11. 1. 학원 오픈한 ""수학을... "
수능 수학1 문제집 추천	"... 수학은 개념을 익힘과 동시에 개념문제, 유형문제를 동시에 풀며 감을 익히는 것이 좋아요 ! 수학에 대한 감을 익히시고 싶다면, 수학 큐레이션 풀리를 추천드리고 싶어요! +_+ (일단 한 번 들어보세요(...)) 완전 내 맞춤으로 등급... "
수학인강 추천좀용~	수학인강 추천 좀 해주세요 개념을 정리하면서 문제를 어떻게 푸는지 설명 잘 해주는 그런 수학인강 선생님 강의면 좋겠어요 개념정리와 문제 분석 하면서 수학틀을 잡아주는 강의를 원하시면 이은미선생님 수학인강 좋아요 지티에듀... 
예비고2 메가스터디 수학 인강	... 쉽게 알려주시는 분의 느낌이 좋아요..ㅠㅠ 저희 학교 수학 문제 난이도가 어렵지 않은 편으로 나오는데 독학을 해도 괜찮겠죠..? 1학기땐 교과서에서만 나오고 2학기 일차고사때도 교과서만 나오고 이번에 이차고사때 모고 한문제... 
수학학원 다니고싶어요 부천상동 까지도 신중동 좋아요	좋은학원이 있다면 꼭 다니고싶어요 부천중동쪽이나 상동까지도 좋아요 아이들은 고1 그리고 중2 학생인데 보내보려고해요 아이들 숙제도 많이내주고 관리도 잘되었으면 해요 영어 그리고 수학 레벨이 조금 많이 낮아서 이해 부탁해요... 
학원 수학 선생님 되는 방법	... 수학까지는 좋아요... 그런데!!! 영어 : 65(?) 과학 : 80~95 사회 : 70 국어 : 85~90 이런데... 한문은.... 중간: 18 (헉!) 기말 : 24(ㄷㄷ) 이렇게 죽자식이에요... 한문엔 확실히 재능이 제로에 가까운듯... 그래서 결국 평균은 6~70.... 이런데 학원... 
바이블vs개념원리vs수학의 정석 뭐가 제일 좋아요?	중2 1학기 수학 개념서를 살려고 하는데 뭘 사야할지 모르겠어요ㅠㅠ 참고로 저는 중1이고 중2수학문제집 처음 풀어보는 겁니당 수학의 바이블이 나아요!! 개념원리는 개념서라고 하기에 개념설명이 너무 안되잇고 정석은 너무 딱딱해요 
마곡엠밸리 영어학원 수학학원 공부방같은곳도 좋아요!	... 마곡엠밸리영어학원 마곡엠밸리수학학원 찾고 있어요 실력이 좋은곳이 있을까요.. 잘하는곳으로 가고싶네요  안녕하세요^^ 마곡엠밸리 수학 학원을 찾고 계시는군요! 학생마다 부족한 부분과 그에 맞는 공부 방법이 다 다릅니다!... 
초등학생 수학 문제집은 뭐가 좋아요?	... 확실히 수학 공부하는데 도움이 되고 재미있게 할 수 있는 우등생수학을 추천 드리고 싶네요~ ^^ 우등생수학은 12주... 단원평가 문제집을 별도로 제공하니 전과목으로 개념을 잡기에도 좋아요! 답변이 도움이 되셨으면 좋겠네요~
수학의 바이블 이랑 정석이랑 뭐가 더 좋아요?	... 정석으로 공통 수학을 공부하셨다면.. 이미 몸에 벤 문제집이 좋아요.. 솔직히 문제집의 내용은 거기서 거기입니다... 저희때도 정석과 개념원리 가지고 말이 많았는데요.. 제가 대학와서 고3 과외해보니까.. 그 문제집이 그 문제집... 
"예비고1, 중학수학 마스터할수있는 문제집 추천해주세요"	... 중학 수학 개념 총정리가 좋아요. 제가 현재 풀고 있는 문제집인데 개념과 문제가 단기간에 마스터 할 수 있는 정도의 수준이라 가장 좋은 책이라 생각하고 무엇보다 고등과정연계중심으로 나가다 보니 예비고한테 가장 좋아요:-)
"노원쪽 수학, 영어학원 어디가 좋아요?"	"... 을다녔는데 외고입시로는 종합반이 한계가 있더라구요. 수학학원,영어학원추천해주세요.. 학원비도알면알려주시고요^^ 청담어학원과 페르마가 가장인기 있구요 20마원이상입니다. 노원쪽은 잘 몰라서.. 잘 아는 분이 다음에 쓰겠죠 "
큐브수학디딤돌	큐브수학이좋아여 디딤돌이 좋아여? 설명이랑요점정리 어느 책이 더 이해하기 쉽게 나와있나여? (경험있으신분이있음 적어주세여) 경험없으신분도 책보고나 생각 적어도 되여^^ 저는요 그렇게 크게 차이가 안나는것 같은데 난위도를... 
수학 문제 풀이쫌 해주세요 풀이과정까지 세세하면 더... 	아까 올렸는데 문제들이 안보여서 다시 올립니다ㅠㅠㅠ 첫 문제부터 멘붕이 오네요...ㅠㅠㅠ 대학교 수학문제입니다ㅠㅠㅠ 대학수학이라구요...? 대체 무슨 과목이길래 이런 문제를 줍니까? 
중1 수학문제집 추천	"... 이문제집들은 다 풀긴풀었어도 이해가 잘안가거든요 ㅠ_ㅠ *질문!) 문제집 추천좀 2~3개정도만요!~ 시험전에는 파란이랑 쎈수학이 좋아여,., 딴것도 나쁘진안치만 시험문제랑 가~장 유사하게 나왔거든여.. 저두 시험전에는 이두권을 꼭... "
수학 나형으로 생물학과	"... 과학과 수학이 좋아 이과로 오긴했는데 수학점수가 심각하게 안나와요. 제가 가고싶은 학과는 생명공학, 생물학과, 신소재학과에요. 그런데 이런 학과를 수리 나형으로도 갈수 있는 대학이 잇나요?. 있다면.. 알려주세요 ㅠ.ㅠ 수학... "
일반인 수학공부	"... 학창 시절 수학을 좋아하는 편이었고. 이과였고, 수리영역도 1,2등급 맞았었고, 대학생 시절에는 수학과외로 용돈도 벌고는 했습니다. 전공이 수학과 거리가 멀어서 수학공부를 이후로는 안했지만 일상에서 취미로 수학공부를... "
수학기출문제집 인강병행 뭐가 좋아요	수학인강 듣고있는데 이것만 들으면 안되잖아요 ㅋㅋ 수학기출문제집도 풀어야하는데 아직 수학기출문제집 안샀...... 이틀에 아님 주말에 한회씩 풀면 좋은 수학기출문제집 추천 좀 해주세요ㅠㅠ 제가 아는거라고는ㅜㅜ 수학기출문제집... 
수학 잘하는 방법	... 저는 사실 수학을 좋아합니다.. 수학을 좋아 하면 할수록 수학과는 거리가 가까워 지게 되는 거죠... 님께서 수학을 잘 하고 싶으시다면 수학을 좋아해보세요^>^ 그러면 수학을 하고 싶어지고 그러면 수학을 잘하게 되는 것입니다...... 
경주로가는수학여행 질문 ^.^;	... 7.옷은 몇벌 가져가면 좋아용? 수학여행 갔다오신분만 답변해주셨으면 좋겠네요 ^^ 경주로 수학여행 갔다오신분이시라면 더욱더 좋구요 : ) 글읽어주셔서 감사합니당 질문 빠르고 정확하게 해주시면 좋겠네요 내공 20이구용 +ㅁ... 
남자친구랑 수학 과외 질문!	"... 진짜 너무 멋지죠 ㅠ 저도 수학만 아니면 성적 좋아용! 수학 포함해도 반 3등이긴 한데 저희 반이 반 등수 꼴찌라 ㅎㅎ 암튼 과외를 하게 된다면 남친이랑 수준 차 때문에 고민이에용 ㅠ 남친은 제가 수학을 안해서 그런 거지, 다시... "
6세수학 어떤게 좋아요?	"... 아인슈타인수학에서 나온 아빠가 초콜릿을 사왔어요. 도넛가게에 왔어요, 유치원에 갑니다 등등 많아요. 지금 파는지 모르겠는데 저는 공부방에서 저걸로 공부했는데 아이가 경험하는 일상 속에서 좋아하는 것들로 수를 경험하고... "
4세 수학전집 뭐가 좋을까요?	... 매일같이 대발이 보구요 아이가 좋아해요. 제가 생각지 못한 부분까지도 여러개념을 다루어서 생활에 유용한 점이 많구요. 특히 어렵지 않고 소재가 친근해서 첫 수학전집으로 좋아요~ 공룡대발이 수학동화 추천해요. 
수학여행 옷 추천좀 해주세요!	... 키가 커보이는 옷이면 더 좋아요!)  안녕하세요! 수학여행에 적합한 옷 추천을 해드릴게요. 1일차 놀이공원에서는 편안하면서도 활동하기 편한 스포티한 옷을 추천해드립니다. 반팔 티셔츠나 블라우스에 반바지나 면바지를 매치하면... 
수학1 관련도서 관광분야 수학도서	"수학1관련 수학도서 중에 문과 관련된 내용이나 경영 경제 분야나 관광분야 관련된 책 있으면 알려주세요 관광분야면 더 좋아요ㅠㅠ 급해요 내공 300이요  인문학 관련 수학 책 추천드립니다 https://link.coupang.com/a/ZECt7 ""이... "
겨울방학때 수학1 어디까지 해놓는 게 좋아요?	"... 수학1 어디까지 해놓는게 좋아요? 저는 참고로 이과지망생입니다. 이과 지망생이시면 수학1에만 집중 투자 하는것보다는, 먼저 수학1에서, 수열의극한까지 초스피드로 끝내시고 수2를 병행해서 하시는 것을 추천합니다. 수학1을 다... "
수학과외사이트로 수학과외 전문선생님 찾는 방법?	"... 중3~고2 정도 많이 하시는 분이면 좋아용! 수학과외사이트 간단한 곳도 추천해주심 좋겠습니다,  성적향상 세심함과 꼼꼼함 우리 아이들 성적이 오르지 않는 근복적인 원인을 찾아 문제를 해결하는 해답과외 알찬... "
중2 자녀가 수학 성적이 너무 안좋아요.	... 혹시 저는 아직 잘 모르겠어요 진짜 노력을 했다면 성적이 좋아야하는거 아닌가요(비하할 목적은 아닙니다) 저는 문제집을 보통 개념원리 쎈 블랙라벨 순으로 풀었습니다. 수학은 개념입니다. 그래서 개념을 확실히 이해하고 점점더... 
제주 노형동이나 연동 근처 수학학원 영어학원 있나요?... 	"... 영어,수학 찾기는 한데 자세한건 다른과목도 상담해봐야할듯해요 기초가... 노형동영어학원 노형동수학학원 찾으셔서 답변드려요.^^ 과목 수업뿐만이... 노형동초등학생수학학원 노형동중학생수학학원 노형동고등학생수학학원 노형중... "
수학여행때 장기자랑 하려는데 어떤 노래가 좋아요 ??	... 수학여행을 가는데~ 장기자랑을 하거든요 ? 장기자랑 하는거니까 당연히 춤 아니면 노래겠지요 ... 어떤... 참 좋아/ 인원 - 4~6명 2)자우림/하하하송/ 인원 - 1~3명 3)쥬얼리/바보야/ 인원 - 4~5명 발라드노래♡ 1)이승기-삭제... 
복대동 중등 수학과외 영어과외 없으면 가경동도 좋아요... 	중학생 입니다 복대동 아니면 가경동 수학이랑 영어과외 추천좀해주세요~!!  안녕하세요 복대동에 있는 중학생 고등학생 수업중인 7년차 Doit쌤입니다. 과목별 기초부터 심화 응용과정까지 학생 개개인의 취약점을 파악해... 
알려주세요~ 수학학원 같이 봐주는 곳이면 좋아요!	... 당산래미안수학학원 같이 알려주시면 좋을 거 같아요 혹은 두... http://naver.me/535rB63N 당산래미안국어학원 당산래미안수학학원... 당산래미안초등수학학원 당산래미안초등영어학원 당산래미안초등국어학원 당산래미안중학생수학학원... 
(빨리답공부탁)4학년1학기수학문제집뭐가좋아요???	"(저급해요)4학년1학기수학문제집뭐가좋나요??? 빨리답공부탁해여 저한테도움되고이해잘대는걸루여빨리부탁해요  음.....저도 윗분과 같은 생각이예요!!!!!!!!!! 저라면 쎈이라던지.....우공비,RPM등 많아요!!!!!!!!! 그중 쎈이 가장어렵고... "
독후감용 수학 책 추천	"... 유명한 책도 재밌는 책도 좋아요. 200쪽 이하면 좋겠어요. 고등학생이 읽을 만한 수학 관련 책으로는 다음과 같은 것들이 있습니다. ""무한으로 즐기는 수학"" - 허윤식, 나눔의집 (186쪽) ""유적의 수학"" - 존 시몬스, 북하우스 (224쪽)... "
중3수학문제집 추천이요!!	... 꿈틀이나 파란도 꾀좋아요 수학: 자습서먼저보시구요 투탑수학이 진도용으로 아주좋아요 투탑이랑 개념원리수학(최고!!)을 병행하세요~ (수학은 많이푸는게 중요해요!) 다 익혀지면 하이레벨 에이급수학 그런거 사서 푸세요 사회... 
"영어, 수학학원"	"... 전문이면 좋아요 5)수학만전문 영어만전문 잘가르치는곳도 괜찮습니다 비용도 써주시고요 선생님도 재미잇으면 좋아요 6)잘가르치는 영어,수학 온라인 강의 같은거 좀 추천 급합니다  안녕하세요^^ 수학 영어를 전문적으로 10년동안... "
수학 인강 추천	... 메가스터디 패스있고 대성도 추천해주세요 이비에스도 좋아요. 그런데 메가 김성은 쌤이랑 이비에스 생강 수학은 추천 하지말아주세요. 찾아봤는데 저랑 잘 안 맞아요 고1 수학은 ebs에선 정승제쌤 개념끝장내기. 메가스터디는... 
수학공부 잘하는 방법! <내공 50★>	... 수학 경시대회 같은건 진짜 점수 안좋아요... 수학 잘하는 방법 좀 갈켜 주세요. 다른 과목도 다 갈켜 주심 감사하겠씁님다. 수학 제가 생각하기론 수학.. 솔직히 학원 필요 없습니다. 처음엔 문제집 한권사서(개념을 이해하기에는... 
수학을 못하는데	솔직히 수학 넘 못하거든여 꿈은 수학이랑 전혀 상관 없는 거고 중간고사 때 수학을 30점 맞았어여 공부는 딴건 걍 중상 쯤 되는대 수학이 젤 안좋아여 수학 30점 맞아도 이과 영문과 등등 갈수 있죠? 일단 문과이면 수1 공부하실텐데... 
마포동 수학과외 당인동 영어과외 어디가 좋아요?	마포구수학과외 마포구영어과외 가 필요한 중2 학생입니다. 도형부분을 많이 어려워하는 아이이고 수학이 많이... 마포동수학과외 마포동영어과외 빠르게 구합니다. 거리상으로는 가까워서 당인동수학과외 당인동영어과외 선생님도... 
수학 문제 잘푸는 법	"... 시험볼때도 다른거 다 좋은 데 수학만 안 좋아요,, 특히 분수문제인데요..암산력이랑, 이해력같은게 떨어져염.. 정리 1...........수학문제 잘 푸는 방법을 알려주세요.. 2...........빨리 푸는 방법을 알려주세요. 3...........암산력 기를 수... "
수학 인강 추천해주세요	"... 첫수학 수학 상 뭐가 좋을까요?? 저는 개념을 중요하게 여기는 편이고, 설명이 자세했으면 좋겠어요! 내공 100이요..!  ebs에 정승제쌤 개념끝장내기도 좋아요. 수상 수하 강의구요. 내신은 아무래도 무료인강 ebs가 갑이구요. 사설은... "
예비중1 수학 문제지 추천!!	... 개념+유형+심화 한꺼번에 있는 수학책도 좋아요!! 그리고 rpm이랑 쎈중에 뭐가 더 좋을까요? 쎈은 (하) 가 좋나요?? 안그럼 (상) 이 더 좋나요?? 상 이랑 하 무슨 차이 인가요? 상이 더 좋나요?? 하가 더 좋나요??  안녕하세요 친절한 수학... 
6학년 수학 문제집 추천해주세요	"... 개념과 문제 풀이 영상까지 학습할 수 있고, 세트로 구매 시 1~2학년 연산문제집, 3~6학년은 단원평가 문제집을 별도로 제공하니 전과목으로 개념을 잡기에도 좋아요! 6학년수학문제집에 대해 답변드렸는데 도움이 되셨으면 좋겠네요~ "
중1 수학 문제집 어떤게 좋아요?	"이번에 중1 올라가는데요 수학 문제집 좋은 것 좀 추천해주세요 난이도... 나온 '투탑수학' 이 세가지를 기초다지기로 가장 많이 씁니다. 난이도 별2개를... (하이레벨, 고난도수학, 에이급수학, 엑스샵 등...) 영어는 보통 맨투맨이나 능률... "
수학의 정석과 개념원리 중에 뭐가 좋아요??(고2되는사람)	... 수학의 정석은 고등학교 수학 배우면서 must have 필수과정이죠. ㅋㅋ - 정석에서 연습문제가 나오는데요 기본편은 개념을 응용하는데 좋아요 실력편은 기본편에비해서 연습문제가 더 많이 어려워요 실력편 연습문제(유제는 기본)까지... 
수학 인터넷강의 어디가 좋아요?제 점수가ㅜㅜ	"... 수학점수가 20,30점대여서 걱정인데요ㅜㅜ 수학 인터넷강의 어디가 가장 좋아요?? 점수 많이 올릴 수 있을것 같은........  인강은 유명강사만을 생각하고 듣는 경우가 있는데...제 생각은 조금 틀려요. 유명강사님도 좋지만 내 실력과... "
수학 공부하기 싫을때	... 원래 수학 안좋아 했는데 요즘들어서 진짜 진짜 완전 못하겠어요 ㅠㅜ 한 2~3문제? 풀면 갑자기 순식간에 집중력이 확! 깨지면서 짜증만 나고 문제 보기도 싫고 아무리 이 악물고 문제에만 집중하려고 해도 안되요... 노래도 들어보고... 
수학 학원이나 과외하면 좋아여?	"... (사람마다 많이 다르긴 합니다^^ 제 친구들 중에는 독학으로도 충분했다는 친구들도 있구요, 재수학원시절이 가장 도움이 되었다는 친구들도 있습니다. 그리고 과외도 도움이 되었다는 친구들도 많구요~ 참고로, 전 재수 안하고... "
중2-수학 문제집 에서 어떤것이 좋아요??	"... 그런 공식도 잘 나와있어요 또 문제 양도 많아요 WORK BOOK 이라고 뒤에 별책으로 있어요 참좋아요.. 해답도 친절하구, 풀이과정도 잘 나와있고 전 파란수학 추천해요. 2번풀어도 안아깝습니다. "
초6女수학여행 질문좀여 ~	... 애들이랑 모여서 노는거죠.ㅋㅋ 3.좋아요 수학여행이니 어디가 안좋아도 애들이랑 다같이 가는데 뭔들 안좋겠습니까.ㅋㅋ 4. 버스에서 뭐 여러가지 있죠 제로게임이나 에비씨게임 이런거 간단한거 하세요ㅋㅋ 에이비씨 게임 이거....... 
수학 문제집 질문!	... 쎈 수학도 좋아보이던데.. 고 1 수학 심화책 추천좀요 !  음.... 일단 제가보기로는 수학의 정석과 개념원리 RPM이 좋을 것 같네요 저희반 탑랭킹들은 다 그거풀거든요 되도록 문제수가 많은게 좋아요
"중학생수학,영어"	... 학원추천 부탁드려요(경험담이면 좋아요!) 수학학원을 다니시려면 한반에 학생들이 적은게 좋아요. 그만큼 선생님이 한명한명 신경을 써주시기 때문에 모르는 문제 같은것도 흐지부지하게 넘어가지 않고 정확히 알수있거든요 . 이상... 
수학 진도 질문	... 적어도 기출은 해야해서 (응용력이 안 좋아요) 미친개념ㅇ은 꼭 해야할것같어요 몇월달 안에는 끝내야 기출공부할 시간이 확보된다<< 이런 것도 말씀해주세요 언제끝내야 적당한건지도 모르겠고 너무 느린 것 같고 그래서요 수학... 
이야기 속의 수학	... 해리포터 이런거 뭐 다 좋아요 (수학에 관한 책만 아니라면) 조금 까다롭긴 하지만 그래도 올려봅니다. 저는 수학에 관한 책이 아닌 평범한 책속의 수학을 원해요. 아무 책이나 괜찮아요. 제발 답을... 
수학 과외쌤이 너무 좋아요	수학 과외쌤이 너무 좋아여 ㅠㅠㅠ첫눈에 보고 반했는데 보면볼수록 설레고 과외하기전에 막 떨리고 이뻐보이고싶고 그래요 ㅠ 나이차이는 2살차이에요 과외 한지는 이주 정도 지났는데 저한테 남친있냐고 물어봐서 없다니까 한번... 
올림피아드 수학문제집이 좋아여 아뉨 3000제가 좋아여?	"... 올림피아드 수학문제를 푸실 수준이라면 3000제는 풀 필요가 없을 듯 보이구요 수학실력이 학교내신정도이다.. 하는 정도시라면 올림피아드 수학문제는 어렵습니다. 그리고, 3000제는 왠만해서는 다 풀기 힘들어요. 수학을... "
진짜 진지하게 수학공부 질문 합니다..	"... 안녕하세요, 수박씨 멘토입니다.~^^ 수학을 좋아하는 학생이기 때문에 가능성은 충분히 있습니다. 수학은 단기간에 절대 될 수 없습니다. 조급함을 버리고 꾸준히 하는 부분이 제일 중요합니다. 여러권 푸는 것보단 한 권을 제대로... "
화학 속 고1수학	"... 순수 화학이 좋아요 → 화학과 수학, 물리, 화학 전부 좋아요 → 화공과 대충 이런 느낌일까요? 일단 학과나 학부 이름에 공학(Engineering)이라는 이름이 들어가는 순간 수학, 물리는 필수라고 보시면 돼요. 그래서 대학 1~2학년 때 보통... "
수학문제 풀이과정과 답 알려주세요 .. 댓글만 달고... 	"수학문제 풀이과정과 답 알려주세요 .. 댓글만 달고 사라지지 마시고 .. 친구와 프로필 좋아요도 눌렀는데 ,. 참고하세요 "
"영어,수학 문제집[고등학교대비]"	... 2.고등학교 대비 수학문제집을 여러권 추천해주세요^^[난이도 별로 추천과 문제보단 이론이 많이 들어간게 좋아요] 수학 문제집 기본은 [수학의 정석]입니다. 우선 님께서 원하시는 이론이 많이 들어간 다는 점이 있고 대부분의... 
고등학교 1학년 수학 과정과 반도체 연관시키기	"... 많을수록 좋아요!! 안녕하세요! 반갑습니다. 답변: 안녕하세요! 고등학교 1학년 수학 과정과 반도체의 연관성에 대해 알려드리겠습니다. 우선, 수학은 반도체 제조와 관련된 여러 분야에서 사용됩니다. 예를 들어, 물리학과 화학에서... "
"수학여행에 대해서,,,,,,,,"	... 제가 서울로 수학여행을 가는 데요...서울로 가면 좋아요??? 4. 수학여행에 가면 장기자랑이 있어요??? 5. 교관 있어요???? 6. 휴식 시간이 많아요????? 7. 취침 시간은 언제고 기상 시간은 언제예요????? 좀 많죠......죄송해요.....그래두 하나... 
경주 수학여행가는데요 .	... 경주삼성유스텔좋아요 ? 3. 수학여행때 입고갈옷 코디좀요 얼굴은좀 큰편에 키는 161cm 몸무게는 58kg인데 뭐입으면 좋을지좀 .. 4. 무슨노래 부르면 분위기 띄울까요 ? 5. 뭔 놀이 해야 재밌어요 ? [수학여행밤에] 6뭔 놀이 해야... 
수학공부 열심히 하는 법	... 성의있는 답변 부탁드리고요/~^^ 욕설과 비난은 하지 말아주세요/~^^  매일 1시간 집중만 하면 충분해요 초3이면 이제시작이니 걱정말고 화이팅 수학이 어렵줘 문제집이나 유투브 강의 듣거나 ebs도 좋아요 수학책이나 수학과가까운... 
수학 극한 문제풀이 부탁드려요! 빠르면 빠를수록 좋아... 	이 문제 풀이 부탁드려요 풀이입니다 
"예비 고1 수학, 언어, 영어 공부?"	"... 겨울방학때 예비고1 수학 진도 어디까지가 좋아요? 2. 제가 만약 수학(하) 기본을 수강하고, 심화도 수강하면 그 효과가 괜찮을까요? 그러니까 예를 들면 아침에 기본 을 듣고 오후에 심화를 듣는 방법.. 막 개념이 바로 안잡혀서... "
수학 책 추천	... 들어보시면 좋아요. 그리고 수학은 학생의 스타일과 현재 상태를 명확히 알고 선택을 하셔야 해요. 인강은 학생들이 이해를 했는지 선생님이 확인을 못합니다. 그래서 이해를 한다는 전제하에 선생님이 수업을 진행하고 학생들이... 
"중2 수학,과학 영어 문제집 추천"	"... 완자수학안좋아요 그리고 개념이해하셨다면 신사고의 쎈수학!무조건푸세요 이거풀면 수학시험 80점밑으로안갈걸요?자부합니다 2.과학 과학은 오투,완자가 좋은데 만약님학교진도를 선생들이이상하게나가면 완자보세요.완자는... "
호평동 영어학원 수학학원	안녕하세요 빠른 수업 받고싶어요 어디가 좋을지 정말 고민이에요 호평동영어학원 호평동수학학원 최대한 빠르면 빠를수록 좋아요 아이가 공부습관이 빨리 잡혀야해요...  안녕하세요 바르고 선한교육 길라잡이과외 박샘입니다.... 
이상하게 수학과목만 성적이 안좋아요..	"... 비해 수학점수가 아주 저조해요.. 다른 과목들은 다 90점 이상인대.. 수학 시험만 봤다 하면 40점,50점 심지어는 28점.... 수학때문에 정말 평균 8~9점을 깎아 먹어요.. 어째서 과학은 쉽고 이해가 잘가는대, 수학만 마주쳤다 하면 점수가... "
영어 초보자 / 수학 문제집	... 쎈 좋아보이던데 수학도 추천바라요 ㅜ 1) 영어초보자 위한 문제집(!?) 2) 영단어 잘 나와있는 영단어책(?!) 3) 수학 문제집 안녕하세요 친절한 수학 학습서 <아빠마음 중학수학>의 저자입니다. 자기주도 학습으로 수학을 개념 중심으로... 
마곡엠밸리 영어학원 수학학원 공부방같은곳도 좋아요!	... 마곡엠밸리영어학원 마곡엠밸리수학학원 찾고 있어요 실력이 좋은곳이 있을까요.. 잘하는곳으로 가고싶네요  안녕하세요 다홍쌤입니다~ 저희 학원은 학생 일대일 개인별 맞춤진도로 학생에게 집중하는 수업을 진행하고... 
정평동 수학학원 영어학원 알려주시면 좋아요	"... 자녀분 수학 영어 학원을 찾고 계시네요~ 꼼꼼한 관리를 원한다면 소수정예 수업을 추천드릴게요! 재재쌤 학원은... 고민이 되신다면 방문 후 상담 진행해보시고 결정하셔도 좋아요.^^ 진도, 숙제, 교재 모두 학생들 학습 상태에... "
"중2 수학문제집, 어떤것이 좋아요 ?"	"리더스 ,랑, 디딤돌이랑 투탑말고요 , 두드림이랑 개념원리중에 어떤것이 제일 좋아요 ? , ,빠르게요 ,ㅋ 수학 문제집 추천 입니다.~~ ① 순위 개념원리 중학수학 가격 : 7500원 강추 출판사 : 개념원리 중학교 내신대비 수학문제집으로... "
수학 과외비	제가 중학교 2학년이고 수학 과외를 한달 전에 시작했는데요 수학 과외를 주 2회 1시간 30분씩하는데 한달에... 선생님 괜찮은시면 그정도 금액이면 괜찮다고 생각하시고 쭉 ~ 하시는게 좋아요! 학생하고 잘 맞고 수업 커리큘럼 잘... 
고3 수학인강 언어인강 추천 부탁드려요 EBS도 좋아요	"... 언어인강은 이근갑쌤 잘가르치시는데 ㅋ 특히 문학쪽 넘 좋아요! 종합도 괜찮구요! 어쨌든, 수학인강은 전준홍쌤 그리고 언어인강은 이근갑샘 추천드릴게요- 열공하시구요 - 좋은 대학가시길 바래요 ! 이비에스는 시간나실 때 간간히... "
"중1영어,수학공부"	"... 영어책을 많이 읽고, 거기서 나오는 단어나 문장은 그대로 해석하실 필요는 없어요 단계를 처음엔 낮은걸 해서 대충 직감으로 책내용을 알으시면 됩니다 인터넷강의는 역시 EBS입니다 특히 수학이 좋아요 자신만의 공부방법이... "
수학 못하는 학생 고민 좀 들어주세요ㅠㅠ	"... 마음 같아선 수학 때려치우고 제가 잘하고 좋아하는 다른 과목들을 하고 싶지만,, 안되겠죠..??ㅠㅠ 그리고 수학이 부족해도 잘먹고 잘살수 있는 직업이 있다면 같이 말씀해주시면 감사하겠습니다! 긴 글 읽어주셔서 감사해요!!... "
울산 남구쪽 수학과외 영어과외 있나여?	"... 울산남구 인근 모두 좋아요 울산광역시과외 선생님 추천해주세요!  울산 남구 수학과외 영어과외 알아보시네요~ 울산 전지역 일대일 수준별 과외 진행하고 있는 전문 과외 교사입니다. 고1 학생, 초4 아이들이네요~ 기본적으로 과외는... "
마전동 이나 남방동 수학과외 영어과외 어디가 좋아요?	"양주시 마전동수학과외 마전동영어과외 남자샘 여자샘... 수학,영어가 조금씩 흔들리는것 같습니다. 꼭 도움줄 수... 남방동수학과외 남방도영어과외 추천 부탁드립니다.... 영어 수학 학원, 단과학원, 영수 종합학원, 국어 과학 학원... "
이토록 아름다운 수학이라면 독후감 좀	이토록 아름다운 수학이라면 독후감 좀 부탁드려요 ㅠㅠ 길면 더 좋아요!! (탐구스쿨이라고 답변은 하지 말아주세요..)  안녕하세요. 답변드립니다. 안녕하세요! 독후감을 작성하시려는 것 같아서 반갑습니다. 수학이라는 주제로 독후감을... 
영어/수학 고등학교 대비	"... 영어 수학 과학 모두 선행하셔야 좋아요. 인강들으시면서 해도 좋구요. 국어는 문학+비문학+문법+화작 이정도로 나뉘고, 수학은 고등수학 수(상) / 수(하) / 수(1) / 수(2) 요정도 그리고 영어는 고등단어 외우시고 독해,문법... "
영어학원 수학학원 청송마을 쪽도 좋고 공부방도 좋아요	"아이 엄마에요 저는 청송마을 살고 있어요 그런데 고창마을 까지 공부방 또는 영어학원 수학학원 보내볼까 하는데 주변에 잘하는곳이 있을까요?  안녕하세요^^ 고창마을, 청송마을 영어, 수학 학원을 찾고 계시는군요! 학생마다... "
남양주 다산 수학학원 영어학원 질문이요 고1 입니다	"수학,영어 학원을 각각 다니고 있는데 같은곳으로 다니고싶어서요 기존 수업이 고1까지만 받아서 고등학생들이 많이 있는 곳으로 옮기고싶어요 공부방도 좋아요 남양주다산수학학원 다산영어학원 다산국어학원 다산고등학원... "
분당수학학원 고민 ㅠ	... 제 윗분이 말씀하신 분당수학학원도 좋아요~ 유명하고 선생님들 정말 잘 가르쳐요 이 외에도 유명한 분당수학학원 많구요~ㅎ 분당수학학원 상담 받을때 아이랑 다니세요. 그리고 아이와 분당수학학원 나오면서 이야기 자주... 
'수학의 정석'어떤게 좋아요???	"... 그래서 여기저기 검색해보니까, 수학에서는 '수학의 정석'이 좋다는 의견이... 그래서 말인데 수학의 정석 중에 어떤걸 사야 좋을까요?? 참고로, 전 학원을... 수학에서 조금 심화된 문제들에 약한 편이지만, 다른사람하고라도 한번... "
예비 고1 수학 문제집 추천	"... 쎈수학이 좋아요. 개념정리 우선 하시고, 그에 대한 간단한 문제부터 단계별로 어려운 문제까지 풀 수 있어요. 수학은 우선 이해가 가장 중요하고, 문제유형 익히는 것도 중요하거든요.. 그게 한권으로 해결되니까 좋은거 같아요~ 저도... "
수학 1 eds 선생님	... 집중해서 듣기 좋아요. 수학은 학생의 스타일과 현재 상태를 명확히 알고 선택을 하셔야 해요. 인강은 학생들이 이해를 했는지 선생님이 확인을 못합니다. 그래서 이해를 한다는 전제하에 선생님이 수업을 진행하고 학생들이... 
"영어,수학 배워보려고 하는데 공부방 도 좋아요 ^^"	... 미금수학공부방 을 알아보는 것이 좋겠더라구요~~~ 어디 좋은데 있나요? 안녕하세요 경기 분당 미금수학학원 을... 미금영수학원 수업을 진행하기 때문에 더욱더 일대일로... 미금국영수학원 에서는 자기주도적인 공부를 위한 분위기... 
장성마을주변 국어영어수학 종합학원이면 좋아요.	대화중 2학년이고 이번에 사실상 첫 시험봤는데 성적이 완전 엉망....아빠한테 혼나고 애도 울고 저도 속상하고 난리가 났어요. 지금까지 제대로 안 가르친게 후회가 될 정도에요. 반타작도 아닌 과목이 수두룩...그냥 가르치면 되는게... 
"편입 영어, 수학 대하여"	"... 2.편입 영어 단어 ? 1400개? 그런거 문제집 있나요? 이것도 추천줌요 1. 제일 많이 보는 미적분학 문제집은 calculus 에요 수학 좋아하시면 천천히 읽고 이해하실 수 있을거에요 2. 비슷비슷한데, md voca33000 제일 많이 보는 것 같네요 "
고2 이과생 수학 기초가너무 부족한데	"... 사실 저는 수학을 좋아 하긴하는데.. 그동안 수학을 포기해서그런지 기초가 많이 부족한 것 같아요 성적은 반타작이구요,그동안 수학공부도 제대로 안한것같아요. 다른애들은 가외다 학원이다 거기다가 문제집 3권은 기본으로 풀고.... "
중2 수학 문제집 어떤게 좋아여??	중2 수학 문제집 어떤게 좋아여?? 개념도 잘되어있는 문제집이여 개념원리 좋아요~ 능률꺼! 
<6>수학여행 부탁★☆★☆	... 3시간 잡으시면 될거같네요 제가 안성사는건 아니기때문에..-_- 3.비닐가방보다는 매는가방이 좋아요 수학여행에는. 4. 대부분 수학여행에는 교관 없어요. 숙소에는 있을지몰라도 ;;ㅎ 5.-_- 경주에 호텔이나 콘도가 한두갭니까?.. 근데... 
고1 수학(상) 관련 도서	"수학 수행평가 해야 해서요… 고1 수학(상)의 내용이 들어 있는 책 없을 까요?ㅠㅠ 탐구도 해야 돼서 탐구주제로 할만한 내용 있으면 더 좋아요! 리처드 만키에비츠의 '문명과 수학' 어떨까요?? 제가 감명 깊게 읽은 책인데, 수학 상 세특... "
경주수학여행가뉸데..// 궁금한점잇어영@@	... 1.장기자랑무대 시설좋아요/?? 수학여행때가 더 좋았던거 같네요.. 나쁘진 않아요..;; 2장기자랑 조명 좋아요? 그렇다고 보죠..; 3숙소는 어떤가여? 숙소마다 다르긴 하지만 저희 숙소는요 방이 있고 티비 있꾸요 중간문있고 냉장고 있고... 
정평동 수학학원 영어학원 알려주시면 좋아요	... 정평동수학학원 정평동영어학원 정평동국어학원 정평동초등학원 정평동중등학원 정평동고등학원... 정평동초등학생수학 정평동중학생수학학원 정평동고등학생수학학원 정평동수학공부방 정평동영어공부방 정평동고등국어학원... 
경주로가는수학여행 질문 ^.^;	... 7.옷은 몇벌 가져가면 좋아용? 수학여행 갔다오신분만 답변해주셨으면 좋겠네요 ^^ 경주로 수학여행 갔다오신분이시라면 더욱더 좋구요 : ) 글읽어주셔서 감사합니당 질문 빠르고 정확하게 해주시면 좋겠네요 내공 20이구용 +ㅁ... 
수학여행 코디 질문!	... 쓰시는것도 좋아여 수학여행 필수품 알려드릴께요^^ 자 그럼 첫번째! 제일 중요한건 캐리어나 백팩! 근데 나는 수학여행갔을때 백팩을 들고갔어요! 백팩이 캐리어보다 더 좋더라구ㅎㅎ 계단 오르내리거나 할때 캐리어는 불편한데... 
수학의 정석 수1 좋아요?	... 지금까지는 개념원리->수학거미 이렇게 해왔습니다. 1.10-하와 수1 병행해도 문제 없나요? 2.수1 개념설명은 정석이... 답변을 쓰고 다시 질문자님의 글을 보았는데 이미 수학거미를 공부하셨다고 하네요. 수학거미도 아주 괜찮은... 
숙명여고 근처 수학학원	숙명여고 근처에 내신 잘봐주고 잘나오는 수학학원 있으면 알려주세요ㅜㅜ기초만 조금 되고있어서 빡세더라도 잘 나오면 좋아요 좋은 수학학원 알려주세요ㅠㅠ 숙명여고 내신에 맞는  내신 잘 봐주는 학원은 돌파수학학원이 좋은 것... 
수학 인강 추전	... 메가스터디의 현우진 선생님 좋다던데 어떨지?다른선생님 추천도 좋아요! 수학2랑 미적1 모두 많이 부족해서 그런데 둘중에 뭘 들으면 좋을까요.. 등급은 5정도 나오는데 빠르고 정확한 답변 바랍니다.  안녕하세요 수학의 기본은... 
이과 수학 공부법..	"... 특히 문제수를 많이 확보하셔서 비슷한 문제들을 많이 풀어보시는게 좋아요. 수학은 100점 맞을 수 있다는 자신감을 가지세요. 시험문제가 어렵게 나온다면, 나 뿐만 아니라 친구들도 어려울 터이니 이거 안 풀린다고 긴장하지... "
광장동 수학과외 영어과외 어디가 좋아요?	"광장동수학과외 광장동영어과외 지역에서 수학,영어 과외 선생님을 좀... 광장동수학과외 광장동여어과외 추천해주세요  안녕하세요^^ 8년동안... 영어 수학 학원, 단과학원, 영수 종합학원, 국어 과학 학원 전과목 또는 검정고시학원 등... "
고1 수학공부(광고X) 내공500 진짜 절실합니다..	... 진짜 완전 쌩 노베수학공부법좀 알려주세요 문제집 추천도 좋구요 인강 추천도 좋아요 저도 수학 진짜 잘 하고 싶어요.. 광고성 글 제발 하지 마세요.. 참고로 학원 안다녀서 시간 많아요.. 내공 많이 건 만큼 절실해요..... 
수학동아리 만들껀데..	... 1학년 친구들이 수학동아리에 들어오려고 할까요??ㅜㅜ 수학동아리 어떠세요 여러분?ㅜㅠ  저는 좋아요!수학 관심있는 사람 위주로 뽑아보세요 아님 수학을 못해서 수학 공부 고민 있는 사람도 괜찮구요
수학문제집을 사려고 하는데요..	... 문제좀 많이 있는 문제집좀 추천해주세요^^  문제 많이 있는거면 쎈수학이 좋아여^^*(기본문제부터 심화문제까지 있뜨미ㅣㄷㄷ;:) 신사고인듯..ㅋㅋ 그리고 개념을 다지시려면 개념원리중학수학이나 아니면 투탑추천함니닷.ㅋ 심화는... 
수학 모의고사	"... 좋아요............ 하루 7시간 자고 다른 짓은 하지 않고 공부만 한다면 하루에 15시간씩은 공부가 가능할 것 같네요! 다른 공부도 해야하기에 수학공부를 어느정도 할 수 있을지, 얼마나 집중해서 하는지에 따라 다르겠지만, 열심히... "
수학 문제집 어떤 것이 더 좋아요??	"제가 중 3 인데요 수학 문제집을 한 권 더 살려고 하는데, 3000제랑 내신만점 중에서 어떤 문제집이 더 좋을까요?... 제가 내신 만점은 풀어 보지 않아서 잘 모르겠지만 3000제 정말 좋아요 만약 시험이 얼마 안남아서 시험... "
순천 연향동 근처 수학학원은 어디가 좋아요?(	"... 3.준스쿨과 올림수학중 어떤 곳이 더 좋아요? 4.근처에 좋은 학원 추천 부탁드려요~  안녕하세요^^ 반갑습니다^^ 순천 연향동에서 영어,수학,국어 과외 수업하고 있는 공쌤입니다^^ 현재 초등학생부터 중학생,고등반까지 모두 영어,수학... "
수학의정석이좋아요?개념원리가좋아요?(내공많음)	... 제가 중학생때는 수학잘하는편은아니고 항상90점은 넘엇거든요..가끔 88점..; 선배얘기들 들어보면 수학거의다... 문제는 수학의 정석이냐 개념원리냐 이게 문제인데요..... 그리고 제가 혼자서 수학공부할꺼거든요.!! 제가 원래... 
"영어, 수학학원"	"... 전문이면 좋아요 5)수학만전문 영어만전문 잘가르치는곳도 괜찮습니다 비용도 써주시고요 선생님도 재미잇으면 좋아요 6)잘가르치는 영어,수학 온라인 강의 같은거 좀 추천 급합니다  안녕하세요?? 저는 중3학생입니다. 우선 제가... "
정자동 수학 학원좀 알려주세요!	"... 센수학을 매우 좋아들 하심, 바람직한 교재 한수위 수학 학원(고등) 400000원( 매우 유동적이고 정해지지 않음) 으뜸서적건물 2층(디지털프라자 옆건물) 정석(실력), 자체 교재, 기출문제 실력정석을 교재로 쓴다는 자체로 일단 좋은... "
수학여행 궁금	"... 보통 수학여행에서는 가방 대신 캐리어를 사용하는 것이 좋아요. 캐리어는 무게를 지탱하기 때문에 무거운 물품을 담을 때 편리합니다. 또한, 다양한 옷과 물품을 담을 수 있어서 여행 중 필요한 물품들을 잘 담아놓을 수 있습니다.... "
청담동 주위에 있는 수학학원 어디가 좋아요?	내용 무 강남구청역 주변의 주현철 수학 전문학원 추천합니다.!(선생님이 유명하십니다 : 강남구청 강사) 
초등 5학년 1학기 수학 문제집 어떤게 좋아요?? 진짜... 	"초등 5학년 1학기 수학 문제집 어떤게 쓰기 좋아요?? 집짜 급해여 ㅠㅠㅠㅠ 내공 50드려여ㅠㅠ  디딤돌 최상위, 디딤돌 응용, 쎈 연산이 제일 좋습니다^^"
수학공부혼자서하는법	"... 꼭 수학이 아니라도 좋아요. 그냥 자기주도학습하는법..알려주세요 내공걸어요 정말급해요.. 혼자서는 정말 어려운데 .... 그래도 하시려면 일단 개념이해가 필요합니다.. 초등 수학은 강의 없어도 이해가 가능하나, 강좌가... "
고1 모고 수학 6등급	... 일단 이 학교 학과들을 알아보고 이쪽 진로가 마음에 든다 하시면 수학을 안하셔도 상관없고 만약 본인이 그래도 수학을 해야겠다 마음 먹으시게 되면 일단 지금 과외는 바꾸시고 아예 유명한 학원으로 옮기는 것이 좋아보입니다.... 
중학교 수학선생님이 되려면 어떻게 해야하나요?	"저는 개인적으로 수학을 무척좋아 합니다. 그래서 커서 중학교 수학선생님이 되고싶은데요 저가 묻고 싶은건 1,중학교선생님이 되려면 갖추어야할 최소한의조건 예) 성적평균이 80점 이상 2,중학교선생님의 월급 3,중학교 선생님이... "
수학을너무못해요ㅜㅜ도와주세요~	"... 제가엄청쉬운걸몰라하는거같아서 물어보기도쫌그래요ㅜㅜㅜㅜ 휴,어쩜좋아요 수학이넘어려워요.. 자신감도잃었구요 다른분들은어떻게 하시는지요*^_^* 어떻게하는게저한테 좋을지요.... 힘좀주세요ㅜㅜㅜㅜㅜㅜㅜㅜ 지식인에... "
성사동 영어과외 수학과외 어디가좋아요?	"성사동수학과외 성사동영어과외 알아보고 중인... 성사동영어과외 성사동수학과외 어느 샘이 유명할까요?... 영어 수학 학원, 단과학원, 영수 종합학원, 국어 과학 학원... 수업 과목으로는 국어, 영어, 수학( 수리가형, 수리나형 )은 물론... "
수학 잘하는 법	"... 만약 기본적인 수학적 지식이 부족하다면, 이를 보완할 수 있도록 공부하시는 것이 좋아요.. 마지막으로, 포기하지 않고 꾸준히 노력하면 반드시 결과가 있을 것입니다. 수학 모의고사에서 어려움을 겪으셨다면, 이를 다시 한 번... "
[내공30]초4수학문제집추천	"... 음 어려운 것 말고 보통책이면 큐브수학이 좋아요. 기초부터 단계별로 나타나 있더군요 ㅇㅅㅇ 그리고 시험기간땐 딱풀도 괞찮더군요.. 약간 오타가 있는것 만 빼면 말이죠.. 근데 쎈도 좋다고 하더라고요.,. 그리고 완자도 괞... "
"수학문제풀때 줄 있는 공책이 좋아요,"	"수학문제풀때 줄 있는 공책이 좋아요, 줄없는 공책이 좋아요? 수학문제 풀때는 2칸이나 4칸으로 나뉜 노트가 좋습니다. 그리고 질문한 노트는 풀이과정을 잘쓰고 알아보기 편하다하면 무지노트를 써도 되고, 현재 여기저기에 막 써서... "
수학여행갈때 가방큰게좋아요 작은게좋아요?	"수학여행갈때, 가방 큰게좋아요 작은게좋아요?? (참고로 6학년이고 ,여학생입니다 ^^ )  수학여행을 갈 때는 큰 가방을 가져가야 좋습니다. 가방이 커야 공간이 넉넉해서 짐을 넣어도 다른 물건을 넣을 수 있고 기념품이나 선물을 담을... "
6학년 수학여행 준비물	... 하지만 맨발로 숙소를갈수는없으니 삼색슬리퍼를 사서 가져가는것도좋아!! 그리고 수학여행이면 뭐니뭐니해도 기념품and 먹거리지~ ㅎㅎㅎ기념품은 너가 뭘사냐에따라 추억거리가되고 쓰레기가돼.그러니 잘생각하고 사야해... 
제주도 수학여행을 가요~	"제가 내일(07.03.22 목) 제주도로 수학여행을 가요, 주의사항이나 특징있으면 알려주세요~ 경험담좋아요~^^ 수학여행 재미있게 보내는방법도 되도록이면~ 제가어제제주도수학여행갔다가 바로도착했습니다......... 한라산등반을해서... "
고1 수학 유형별 문제풀이 강의 추천 ebsi	"... 수학 유형별 문제 풀이면 강의든 유튜브 영상이든 뭐든 좋아요!! 제가 좀 급해서 드릴 수 있는 게 내공밖에 없는지라 100올려둘게요??  ebs에서 유형풀이는 이하영쌤 강의가 좋긴 한데, 유형을 암기하고 문제를 풀면, 조금이라도... "
비산삼성레미안 근처 수학학원 영어학원 어디가 좋아요?	... 이제 예비 고1 이어서 학원을 알아보고 있는데 비산삼성레미안 수학학원 영어학원 어디가 좋나요??  안녕하세요. 1:1 화상과외 라듀 정상욱 청라센터장입니다. 라듀는 한국은 물론 해외까지 지사를 두어 각지역별로 운영중인... 
어떤 수학문제집이 좋아요?	"저는 중2예요 2학기 수학이 제일 어렵다고해서..왜 쟤가 갑자기 공부를 할려는지는 잘모르는데;; 쟤 성적이 32예요..에헴..ㅜㅜ 한마디로 좀,,꼴통? 아하하하하;; 재친구 한명이 공부를 좀 하는데 쎈이좋데요 저랑 수준이 비슷한예는 쏀... "
고1 수학공부(광고X) 내공500 진짜 절실합니다..	... 진짜 완전 쌩 노베수학공부법좀 알려주세요 문제집 추천도 좋구요 인강 추천도 좋아요 저도 수학 진짜 잘 하고 싶어요.. 광고성 글 제발 하지 마세요.. 참고로 학원 안다녀서 시간 많아요.. 내공 많이 건 만큼 절실해요.. ebs 50일... 
수학인강 추천좀	수학인강 추천 좀 해주세요 개념을 정리하면서 문제를 어떻게 푸는지 설명 잘 해주는 그런 수학인강 선생님 강의면 좋겠어요  개념정리와 문제 분석 하면서 수학틀을 잡아주는 강의를 원하시면 이은미선생님 수학인강 좋아요 지티에듀... 
영어가 좋아요 아니면 수학이 좋아요?	영어가 좋아요 아니면 수학이 좋아요? 둘다 싫어요. 
수학교육과와 관련된 생명과학	... 수학교육과 아니고 그냥 교육학과와 연계할 수 있는 생명과학 개념이라도 좋아요.. 생명과학과 수학교육과 또는 교육학과 간에는 다양한 연계 가능한 개념이 있을 수 있습니다. 몇 가지 예를 들어보면 다음과 같습니다: 유전학... 
6학년인데 수학문제집 어떤거 푸는게 좋아요?	"... 특목수학 초급2권, 창의력 중등1 이렇게 되거든요-;; 제가... 수학 천재교육에서 출판했는데, 난이도가 꽤 높습니다. 진짜 7~8학년들한테는 중간정도인데, 6학년이 일등수학 7... 이건 일등수학 보다는 약간 수준이 떨어지지만... "
수학 선생님에 관해서..?	... 저는 수학학원이 좋아요! 왜냐면 중학교걸 배우는데 실력이 점점 느는게 재밌거든요.. 솔직히 수학을 잘 못할수도 있잖아요? 학원은 그걸 보완하기 위해 있는거구요.. 이제부터 제가 어제 본걸 말해드릴게요. 저는 중학교 반비례... 
2학년 수학 어떤게 좋아요?	"여름방학도 끝나가구 해서 수학 문제집을 한 권 살려고 하거든요? 제가... 수학은 잘 못 하는 편이 거든여;;ㅜㅜ 그래서 님 들의 도움이 필요 할 듯... 죄송 수학은 1,2학기가 합쳐져있어 지금사면 좀 돈이 아깝습니다 . . 그래서... "
고등학교 수학 공부 방법	"... 그때그때 문제집을 통해 내가 잘못 이해한 부분과 까먹은 내용을 체크해보는 것이 좋아요.. 수학 문제집은 눈으로 한번 훌터봤을때, 내 마음에 들고, 70~80%정도 풀수 있을 것 같다는 느낌이 드는 것을 구입하세요.. 아니면 개념원리나... "
호평동 영어학원 수학학원	안녕하세요 빠른 수업 받고싶어요 어디가 좋을지 정말 고민이에요 호평동영어학원 호평동수학학원 최대한 빠르면 빠를수록 좋아요 아이가 공부습관이 빨리 잡혀야해요...  안녕하세요!해달샘입니다. 호평동 영어학원 수학학원을 찾고... 
수학 노베 재수생	수학 노베 재수생인데요..! 지금 EBS 50일수학을 듣는 중입니다.. 수능까지 6달 조금 더 남은 상황에서 9월전까지는... 인강 + 학원 or 인강 + 개인과외병행하는게좋아요. 실력을 올리는데 효과적인 순서는 1:1 개인과외 > 학원 > 인강 독학이... 
알려주세요~ 수학학원 같이 봐주는 곳이면 좋아요!	"... 당산래미안수학학원 같이 알려주시면 좋을 거 같아요 혹은 두 과목을 같이... 수학수업: 수학의 꼼꼼한 개념이해수업, 부족한 개념보충 지도와 응용문제... 확률과통계/ 수학1/ 수학2 각 부분 지도로 계열별 맞춤지도 합니다~! 영어수업... "
수학 문제집 질문입니다.^^	"... 저는 개인적으로 투탑수학을 추천하구요, 그 외에도 개념원리, 깜지 중학수학이 좋아요 ㅎㅎ 이 문제집을을 풀어보니깐 금방 이해가가고 흥미가 생기더니 성적이 올라가더라구요^^ 한 번 풀어보시는것도 좋을것 같네요 ㅎㅎ"
6학년 2학기 수학문제집 어느것이 가장좋아요 ????	... > 부록지가 복습용으로 참 좋더라구요;; 그리구요 다른것두 거 있는데;; *이비에스 수학 문제집 도 추천 합니다;; 이건 이비에스 홈페이지에 가면 강의랑 함께 들을 수 잇으니까 ㄴ 더 좋아요^.^ 
고3수학과외 전문 어떻게 구하는지?	... 1대1수학학원도 좋긴 좋아요 좋은 샘으로 추천부탁드려요 과외정보가 없고 제 동네 이사온거라 정보가없네요 성적은 중위권입니다. 좋은 조언바랍니다.  고3수학과외전문 안녕하세요. 저 정민이에요. 쌤들^^ 오늘 중간고사가 드디어... 
"중 1 수학, 집합.."	... 저라면 미치지 않고서야 수학을 좋아 하지 않겠죠 방법은 없는거 같습니다 솔찍히 수학 좋아하는 사람 얼마나 될까요??? (태클로 제가 좋아한다는 사람이라고 하시는분 가만 계십시요) 우리나라 사람중 국어와 수학중 좋아한다는 것을... 
고2 수학학원vs과외	"고2 수학 학원vs과외 안녕하세요 고2 수학 5등급 학생입니다 1학기때는 학교에서 수1, 확통 두 과목을 진도 나가고... (이것빼면 다 ㄱㅊ음)( 저 혼자 확통인강은 진도는 느리지만 확통쌤이 너무 좋아요ㅜㅜ근데 진도 느린것두 문제..... "
수학 영어 학원	"... 집안 형편이 별로 안 좋아 학원을 못 다니는데, 영어 수학은 독학으로도 가능하나요? 안녕하세요. 목동 길벗아카데미 영어 수학학원 전 영하입니다~ 공부는 의지를 갖고 스스로 주도적인 학습을 하는 것이 가장 좋지만 혼자... "
영어하고수학	영어를 잘하는사람이 머리가 더 좋아요? 아님 수학을 잘하는사람이 머리가 좋나요? 둘 다 머리가 좋긴한데 아무래도 수학이 더 좋죠 
고1 수학관련 책 추천	... 다른책 있다면 알려주셔도 좋아요!! 고1 수학관련 책을 고르시는군요. 두 책 모두 흥미로운 주제를 다루고 있습니다. 더 이상한 수학책은 전작 이상한 수학책의 저자 벤 올린이 미적분에 대해 알록달록한 그림과 유쾌한... 
수학 통계 주제 추천	"... 학생들이 가장 좋아하는 과목은 무엇일까? - 수학, 영어, 국어 등 다양한 과목 중에 가장 인기 있는 과목을 조사하고, 그 이유를 통계로 분석해보는 주제입니다. 2. 선호하는 스포츠 종목 조사하기 - 축구, 농구, 야구 등의 인기 있는... "
50일 수학	"... 완강하고 다른 문제집 푸는게 좋아요. 수학은 기초가 부족하면 응용 안됩니다. 덧셈 뺄셈 배우고 곱셈은 안 배우고 나눗셈을 배워도 나눗셈 문제를 풀수는 있지만, 곱셈과 나눗셈 응용문제가 나오면 풀지 못하는거처럼 기초가... "
"(고2) 수학 눈높이, 구몬, 재능 뭐가 좋아요?"	"고2 인문반 여학생인데요...(지금 수1배움) 모의고사에 충격을 받고-┏ 제가 수학공부 안하긴 했지만;; 그래서 이제... 그리고 여러분 구몬이 좋아요 왜냐하면 상상력.초기력을 키워줘요. 그런데 저가 예전에(나눗셈, 곱셉,분수)를 하였는데... "
급함>>> 중곡동 수학 단과 학원 어디가 좋아요??	"... 사이구요, 수학이 다른과목에비해 점수가 좀 많이 떨어져 수학때문에 평균 다 깍아 먹어서ㅜㅜㅜㅜ 수학 단과를... 중곡동에서 수학단과 괜찮은 학원좀 추천해주세요^ -^*  중곡동인지는 잘 모르겠고요 어린이대공 후문 앞에 있는... "
수학여행 갈때 ;; (내공25)	... 수학여행가면 숙소 좋아요? 4. 전라도로 가는데 날씨는 어떤가요? (10월 8일~10월 10일 ) 5. 교관 무섭나요 ;; 6. 갈때 준비물좀 알려주세요 =ㅂ= << 혹시나 뭐 하나 빼먹고 갈까봐 헤헿 그럼 부탁드립니다 선배님들(응?) 앗 글구 수학여행... 
마곡엠밸리 영어학원 수학학원 공부방같은곳도 좋아요!	... 마곡엠밸리영어학원 마곡엠밸리수학학원 찾고 있어요 실력이 좋은곳이 있을까요.. 잘하는곳으로 가고싶네요  안녕하세요 1:1 소규모정예수업 6년차 베테랑교사 민트쌤이에요. 매번 남들이 좋다는 곳에 보내보셧는데 정작... 
수학 기출문제집 추천해주세요	"올해 수능 대비 할 수 있는 수학 기출문제집 추천해주세요 평가원 3점,4점짜리만 있는거면 더 좋아요!!  수학은 기출문제집의 중요성이 아주 크기 때문에 지금부터 대비를 하시는 것이 좋습니다. 기출문제집은 이미 출제된 기출문제들을... "
인터넷 학원중 어디가 제일 좋아요? 수학정석 좀 하려고... 	"지금 중3인데요,, 수학정석을 해볼려고 하는데,, 혼자하기엔 조금 어려워서요.. 그래서 인터넷 학원을 알아보구있는데,, 어디가 좋은지 잘 모르겠거든요,, 아시는분 좀 가르쳐주세요..  메가스터디죠~`..중학생이시라고요?? 그럼 메가스터디... "
수학 극한 문제풀이 부탁드려요! 빠르면 빠를수록 좋아... 	이 문제 풀이 부탁드려요  요정도>?
중2 수학 포기	"... 대한민국에서 수학 좋아서 공부하는 학생들 10명중 1명도 안됩니다. 어차피 수학은 대한민국 모든 학생이 고3까지 배워야 하는거고 결승점은 똑같습니다. 다른 친구들이 조금 빨리 갈뿐, 가다보면 지쳐서 쉬어야 할때도 있겠죠. 각자... "
"수학여행에 대해서,,,,,,,,"	... 제가 서울로 수학여행을 가는 데요...서울로 가면 좋아요??? 4. 수학여행에 가면 장기자랑이 있어요??? 5. 교관 있어요???? 6. 휴식 시간이 많아요????? 7. 취침 시간은 언제고 기상 시간은 언제예요????? 좀 많죠......죄송해요.....그래두... 
고1 수학 문제집 추천	수학 과외인데 개념원리와 수학의바이블중 뭐쓸지 고민돼요(4등급임 성적이 난) 개념원리는 설명(특히 공식유도... 뭐가 좋아요?  내신 대비 연산훈련서로 수력충전 시리즈 추천드립니다. 수포자들도 쉽게 개념을 정리하고... 
일산 덕이동 수학학원 영어학원 친절한 곳으로..	... 중2 학생이랑 초6 학생 같이 보낼 수 잇으면 좋아요. 일산 덕이동 수학학원 영어학원 친절한 곳으로.. 안녕하세요. 일산 덕이동수학학원 덕이동영어학원 찾아요... 일단 이전에 다니던 학원이 아이에게 좀 무섭게 가르쳐서 친절하게... 
수학여행방탈출..	"... - 세curity guard가 있어서, 방 밖으로 나가는 것이 힘들다면, 안전을 위해서 기다리는 것이 좋아요. **3. 재미있게 보내는 방법** - 수학여행은 처음이라 어색할 수 있어요. 하지만, 새로운 친구들과 함께하는 여행을 즐길 수 있는 좋은... "
수학이 좋아요	"수학이 좋은데 문제가머냐면 수학을 좋아하는거때문에 다른과목이 너무 재미가없어졌어요 어떡하죠 흑흑 진짜로 하..ㅠㅠ 국어 한국사 이런과목들이 너무 싫어요 에휴  한국사는 문과 3등급, 이과(예체능) 4등급 이상 못... "
중학생 수학 학습지 뭐가 좋아요?	이제 중3 올라가는데요 영어는 학원 다니고 수학은 학습ㅈㅣ를 해볼려고 하는데 학습지 뭐가 좋아요?? 답변 꼭 부탁드려요^_^ 저는 이번에 고1 올라가는 학생입니다. 구몬이나 기타 학습지는 거의 계산 위주로 회비가 아깝다는 생각이... 
수학2문제집추천해주세요	"... 그거는 학원같은대서 진도용으로 많이 나가니깐 개념잡히는데는 좋을꺼같구요,ㅎ 개념을 잡읆꺼면 개념원리가 좋은데요^_^ 좀쉬우면서 개념을 잡을려면 파란수학이 좋아요,ㅎ 요새 파란수학이 인긴데ㅎ 저는 왜그런가 해서... "
수학문제 (거의 수수께끼?)	"... 그냥 풀어가면 좋을것같아서요 ㅎㅎ 문제 쓸게요 수 수학수 수학이학수 수학이좋이학수 수학이좋아좋이학수 이렇게 써준다음에 ""수학이좋아""는 모두몇개냐고 묻는문제에요.. 이거 풀어주시고 풀이과정도 써주세요~ 내공 30겁니다... "
수학이 잘 않되요ㅠㅠ	제가 수학을 별로 않좋아 하지만 수학이랑과학쪽으로 나가고 싶거든요...ㅠㅠ 그래서 수학을 어쨌든 피할래야 피할수가 없어서 부딪혀 보려구요...그런데..제가 독학을 해서 질문을 할 분도 없고 학교선생님은 바쁘셔서 제가 만족할만한... 
수학공부.	... 푸는것도 좋아요 수학은요 이해인거 아시죠? 모르는것은 넘어가면 절대 안되요~ 몰랐떤것이 꼭 귀신같이 시험에 나와요 모르는것은 알떄까지 파고들던가. 주위분들한테 물어보세요 수학 꼭 잘하시길 바라구요 ^^ 알차고 보람있는... 
보라동 또는 하갈동 수학과외 영어과외 어디가 좋아요?	"안녕하세요 중등과 고등 수학 영어 과외 어떻게 구하면... 보라동수학과외 보라동영어과외 실력 좋은신샘 연락처 아시는 분있나요? 아시는 분 보라동이나 하갈동수학과외... 영어 수학 학원, 단과학원, 영수 종합학원, 국어 과학 학원... "
수학	... 혹시 수학을 좋아 하세요? 어떤 과목을 잘 하기 위해서는 그 과목을 좋아해야 합니다. 그리고 인내와 끈기.. 할 수 있다는 끈기..ㅋㅋ 수학은 문제를 누가 얼마나 많이 풀어 보았는지에 따라 그 성적이 좌우 된다고 말을 해도 과언이... 
"중3인데요, 고1 선행하기에 수학의"	"중3인데요, 고1 선행하기에 수학의 왕도가 좋아요 50일 수학이 좋아요?? 왜그런지 설명즘 해주세요:)  50일 수학은 선행이라기보다는 고등과정의 준비과정입니다. 지금 중3이시면 기말 볼때까지는 그냥 50일 수학 완벽하게 하시고... "
수학시험 30점..많이 심각한가요?	"... 질문???? Q.성적 잘 오르는방법(실제 후기도 좋아요) Q.수학 문제집 추천! (기초부터 시작해서 추천부탁 드려요!),(강의 추천도 좋아욥) Q.수학에 유용한 꿀팁? 알려주시면 감사하겠습니다ㅠ  중1 학생이시네요! 중2 수학 질문에... "
수학 질문 이렇게 계산하는 방식이 먼가요?	... 그런게있는거같은데 설명을 못하겠어서요 자세히 설명좀 부탁드려요 이해력이 안좋아요ㅠ 안녕하세요 굿다운로더 입니다. 해당 질문에 성실답변 만 드리겠습니다. 수학 질문: 이렇게 계산하는 방식이 뭔가요? 이 문제는... 
이관데 수학을못하고 성적이 안좋아요	평범한인문계고등학교를 다니는 한 학생이비다 1학년때 수학성적... 3월모의고사에서 수학12점 언어66 과학40점대[대충] 외국어 20몇점[찍어서] 이정도 나옵니다 고1겨울방학때 수학과외를 했었는데 수학과외하면서 많이 혼나면서 해가지고... 
수학과외선생님 구해요	... 수학이라는 과목은 점차점차 계단형식으로 올라가야합니다 하지만 중간에 빈곳이 생기면 계단이 무너지게 되는것처럼 수학도 마찬가지입니다 지금은 전문적인 수학선생님에게 지난 방식들을 확인한뒤 진행하는게 좋아 보입니다 
신사고에서나온 파란수학과 쎈수학중 어떤책이 더좋아요??	"신사고 좋은책에서 나온 파란 수학과 쎈수학중 어떤것이 더 좋아요?? 둘 다 써봤는데요.. 둘 다 좋아요. 개인적으로 신사고 걸 굉장히 신뢰하는 편이에요. 근데 파란수학보다 쎈수학이 더 문제가 많고, 난이도가 약간 더 높습니다. 그리고... "
수학여행...	... 코디는 어떻게할까요?많이 더울것같구 장마철과 겹칠듯한데...(사진잇으면 더 좋아여) 2. 수학여행은 처음이라 뭘가져가야할지 모르겠어요 수련회갈때와 비슷하게 가면 되나요?? 3. 수학여행갈때 얼마쯤 들고가나요??? (에버렌드가요... 
정릉동 수학과외 영어과외 추천! 어디가 좋아요?	"... 내신보다는 모의고사 위주로 수업을 진행하고 싶은데 정릉동수학과외... 타과목들은 아이가 혼자할수 있다해서 일단 급한 수학영어 정릉동수학과외... 영어 수학 학원, 단과학원, 영수 종합학원, 국어 과학 학원 전과목 또는... "
쏀vs수학별곡	... 그래서 고2 떄도 쏀 살려구 그랬는데 수학별곡이 좋아 보여서 고민 중 이에요. 이 둘 중에 장단점 써서 추천 해주삼/  한가지 물어보겠습니다 수학문제집 수학별곡이란 책 한권만 가지고 공부하시려구요?? 수학은 문제집 한권으로... 
숨마쿰라우데/ 수학의 정석/ 바이블 중 추천해주세요	"... 10나 문제집을 사려고하는데요( 역시나 독학 으로 할 예정입니다) 제목처럼 숨마쿰라우데가 좋아요, 수학의 정석(기본)이 좋아요, 바이블이 좋아요? 수학의 정석은 아직 한번도 풀어본 적이없구요, 10가에서는 그냥 바이블 하나랑... "
수학을잘하게 할려면≥ㅁ≤	... 열심히 공부를 해도 점수가 않좋아요... 수학 잘하는 님들... 좀 비법좀 갈켜주세요.. 수학을 잘하는 방법을 잘 알려드리 겠습니다. 1. 수업시간 만큼 확실하게 수학 공부 하는 법은 없다! 수학 수업시간에는 정말로 신중하게 집중해서... 
경영학과에 다니는데 수학 과학이 너무 좋아요.	"... 저는 원래부터 수학 과학을 좋아하긴 했었지만 그냥 고등학교 과목으로서의 수학 과학이 좋은거라 생각했고, 학문 자체로는 경영학에 제일 관심이 많았기때문에 문과를 선택했으며 결과적으로 원하던 대학 경영학과에 입학했습니다.... "
수학쪽으로 일을하고싶어요	... 제가 공대라서 많은 생각을 해봤는대요 수학처럼 계산 응용 좋아하신다면 공대 추천합니다. 도움되셨으면합니다. 수학 좋아하신다니 공대오면 무척 공부하기 수월하실꺼에요~ 
지니페르마 가 좋아요 아니면 목동페르마 수학이 좋아요... 	1중 돼서 다닐려고 해요 내공 거니까 답변해 주세요 제가 다니고 싶어서요 제발요  목동페르마가 더 좋답니다(^_____________^*
컴퓨터공학과 관련 수학과제탐구 주제 추천	... 급하게 올려보아요 ㅠㅠㅠㅠㅠㅠ 컴퓨터 공학 뿐만 아니라 그냥 수학쪽으로 깊게 탐구해볼 수 있는 탐구주제도 좋아요!!!! 내공 200입니다!!!! 안녕하세요. 네이버지식인 한국OTT연구소입니다. 질문하신 내용 자세히 읽어 보고 복-붙... 
예비고3 수학(선배이시면 더 좋아요 ㅠㅠㅠ)	... 그렇다쳐도 수학이 제일 점수가 안나오거든요 ㅠㅠ... 강한데 수학은 뭘 어떻게 공부해야할지 모르겠어요 ㅠㅠ... 아그리고 수학공부 잘할수있는 방법도 가르쳐주시면 진짜... 3.수학을 어떻게 공부해야할까요?ㅠ 4. 아 그리고 고3... 
이관데 수학을못하고 성적이 안좋아요	평범한인문계고등학교를 다니는 한 학생이비다 1학년때 수학성... 3월모의고사에서 수학12점 언어66 과학40점대[대충] 외국어 20몇점[찍어서] 이정도 나옵니다 고1겨울방학때 수학과외를 했었는데 수학과외하면서 많이 혼나면서 해가지고... 
6학년 가을 수학여행	"... 일단 질문...ㅅㅅ 1.수학여행 가면 좋아요? 2.제가 수련회 때 과자봉지로 가져가서 가방에 다 흘렸어요.보관하기 좋은 과자좀 추천 3.제가 mp3 영화,노래,tv다 되거든요, 10월30일 편성표하고,재밌는 영화,노래 추천 4.옷 간단하게... "
수학강사...	... 수학만큼은 정말 좋아 하는 과목이었고 다시 시작하고 싶은 강한 마음이 생겼습니다. 지금 열심히 중등 수학을 공부 하고 있습니다. 시작한지 3개월 정도 되었고.. 점점 자신감을 잃어 가고 있습니다. 내가 정말 아이들을 잘 가르칠 수... 
용산 수학과외 영어과외 어떻게 찾아보면 좋아요?	안녕하세요?^^ 용산입니다 어떻게 용산과외 찾으면 좋을 지 몰라 질문드려봐요 시간이 부족하다고도 많이하고 남들보다 이해하는 속도가 더딘 아이입니다 고1이고 용산수학과외 용산영어과외 구해보고 있습니다 도움주실 샘 계실까요?... 
영어학원 수학학원 알려주세요 은행사거리 쪽 좋아요	이번에 지방에서 상계동으로 이사왔어요~ 그래서 학원 알아보려고하는데 수학학원 이랑 영어학원 해서 중계동 엄청 유명하다해서 알아보려고하는데 너무 많아서 어디를 가야할지 모르겠네요 아는 맘도 없어서 물어보기도 조금 어렵고... 
수학여행	... 싸가지마시고 거기서 사드세요 아 거기가 좀 더 비싸긴 하지만 애들이랑 같이 사먹는게 좋아요 *수학여행 가시려면 아직 남으신거 같은데 ㅋㅋㅋㅋㅋㅋㅋㅋㅋㅋㅋ 저희 정말 재밌었거든요 님도 재밋게 놀다오세요 ㅋㅋㅋㅋㅋㅋㅋㅋ 
예비고2 수학공부법	... 여러권의 교재를 돌리면서 연습하시는 것보다 한가지 유형교재라도 완벽하게 숙지가 될 때까지 반복하시는게 좋아요. 수학은 늘 개념이 중요하다고 하는데 주변에 수학을 어려워하는 학생들을 보면 유형교재의 문제집만 계속 푸는... 
고2 수학공부법	... 아주 좋아요. 그리고 수학은 학생의 스타일과 현재 상태를 명확히 알고 선택을 하셔야 해요. 인강은 학생들이 이해를 했는지 선생님이 확인을 못합니다. 그래서 이해를 한다는 전제하에 선생님이 수업을 진행하고 학생들이... 
수학여행때 장기자랑 하려는데 어떤 노래가 좋아요 ??	"... 수학여행을 가는데~ 장기자랑을 하거든요 ? 장기자랑 하는거니까 당연히 춤 아니면 노래겠지요 ... 어떤 노래가... 참고 하셔도 좋아요. ※ 작은 악세 사리에도 신경쓰시고, 춤추려면 춤동작을 고려해서 의상고르도록.. 턱시는... "
중1수학 문제집	중1수학 문제집을 사려고 하는데요 쎈수학이 좋아요?EBS수학이 좋아요? 둘 다 살 돈이 없어서 하나만 사야하는게 어느게 더 좋은가요?  쎈이 좋아요 ^^ 난이도 별로 나뉘어져 있고요!! 인기도 많답니다!! 쎈! 강추!
"수학여행때 ,,ㅜㅜ"	"... 카드가져가서 원카드하거나, 진실게임도 좋고, 수건돌리기도 좋아요 ^^ ＃ 수학여행 숙소엔 교관들이 잇나요? 없습니다. 수학여행이니 당연히 없죠.. 죄송해요. 답변이 너무 허접스러워요. 그럼 좋은 수학여행 갔다오세요 ^^ > "
초등 수학 경시대회 어떤 문제집으로 하면 좋아요? 내공30	"수학경시대회를 나가려 하는데 뭘로하면 좋을까요? 안녕하세요? 저는 수학경시를 몇번 쳐 본 초등학생입니다. 저도... 제가 수학도 잘 하는 편이 아니 거든요.. 적극추천하는 문제집의 이름은 ""해법 수학경시 대회 예상문제""문제집... "
급함>>> 중곡동 수학 단과 학원 어디가 좋아요??	"... 사이구요, 수학이 다른과목에비해 점수가 좀 많이 떨어져 수학때문에 평균 다 깍아 먹어서ㅜㅜㅜㅜ 수학 단과를... 중곡동에서 수학단과 괜찮은 학원좀 추천해주세요^ -^*  저는 광개토학원이 좋을것 같은데요,,, 저도 예비 3학년... "
초등4학년남자얘에요 수학선행학습언제시켜야좋아요?... 	안녕하세요 ~초등4학년 남자얘에요 수학선행학습 언제시켜야좋아요?잘부탁드립니다 ~  저는 1학기 빠르게 공부를 하고 있습니다. 그러니까 더 확실히 이해가 된답니다!
중3수학은 어디 출판사문제집이 쉽고 좋아요	... 내공10 걸게요 수학은 진짜 개념원리가 최곱니다 학원안다녀도 차근차근 앞부터 읽으면서 외울만한 공식들은 왠만하면 그 공식사용되는 문제를많이풀어서 외워지게하고요 개념원리는 문제유형이나 뭐 그런것도다양해서 좋아요 ㅋㅋ 
예비중1 수학 문제지 추천!!	... 개념+유형+심화 한꺼번에 있는 수학책도 좋아요!! 그리고 rpm이랑 쎈중에 뭐가 더 좋을까요? 쎈은 (하) 가 좋나요?? 안그럼 (상) 이 더 좋나요?? 상 이랑 하 무슨 차이 인가요? 상이 더 좋나요?? 하가 더 좋나요??  저는 문제집도 좋지만... 
"교재""두탑수학""과 ""개념원리 중학수학""중 어떤게 좋아요?"	... 화이팅! 학원은 안다니시는게 좋아요. 언제까지나 종합반에 맞혀 공부할수 없어요. 혼자하시는 버릇을 기르셔야 해요. 정못하겠으면 수학 딱 이한과목만 과외 하셔서 편하게 공부할 상대를 찾으세요. 
5학년 수학여행	"... 짐을 가지고 갈려면 캐리어가 좋아요, 백팩이 좋아요? 4. 수학여행 가면 교관들이 대부분 전부 무섭게 대하나요? 5. 수학여행은 많이 힘든가요? 6. 가서 잘 때 동물잠옷 같은거 입고 자면 되나요? 7. 기본적으로 어떤 것들을 가져가야... "
수학문제집 어떤게 좋아요? (중3)	"... 어떤게 좋아요?? 이제 중3 올라가는데.. 저희 수학책은 두산꺼에요... 개념원리 1학년때 풀어봤는데 좀 어려운거 같더라구요...ㅠ.ㅠ 어떤게 좋아요??? 아! 문제 많은 걸 소개해주세요.. 요점정리나, 설명은 학원에 다니니깐 별로.. 문제... "
수학학원 다니고싶어요 부천상동 까지도 신중동 좋아요	좋은학원이 있다면 꼭 다니고싶어요 부천중동쪽이나 상동까지도 좋아요 아이들은 고1 그리고 중2 학생인데 보내보려고해요 아이들 숙제도 많이내주고 관리도 잘되었으면 해요 영어 그리고 수학 레벨이 조금 많이 낮아서 이해... 
호평동 영어학원 수학학원	안녕하세요 빠른 수업 받고싶어요 어디가 좋을지 정말 고민이에요 호평동영어학원 호평동수학학원 최대한 빠르면 빠를수록 좋아요 아이가 공부습관이 빨리 잡혀야해요...  안녕하세요! 저는 호평동에서 고등학생을 전문으로 수업... 
뉴런 수학 문제집을 살껀데 상이 좋아요 하가 좋아요??	제가 이번에 중1문제집 수학은 뉴런으로 살려고 생각하고 있는데 난이도가 상이 좋나요 하가좋나요??  초등학교때 문제들 다 알고 수업만 들어도 90점대 찍으신분이면 하를 하면 너무 지루하고 쉽게 느껴질수 있고요 그래서 상. 초딩때... 
영어학원 수학학원 알려주세요 은행사거리 쪽 좋아요	"... 알아보려고하는데 수학학원 이랑 영어학원 해서 중계동... 칼수학학원입니다. 중계동 은행사거리 학원가에 위치한 수학전문학원인데요, 저희 학원은 중등부와 고등부만을... 많은 학부모님과 학생들이 저희 칼수학학원을... "
초등학교 5학년 수학문제	... 왕수학 풀어도좋아요!! 요즘엔 문제지사면 핵심콕콕등을 주기때문에 시험볼때도 편하구요^^ 핵심콕콕은 중요한내용등이들어있는 간편한 책이랍니다^^(엄청 얇아요><) 그리고 문제지 안사시구 하구싶으시면 저에게 쪽지주세요... 
"(고2) 수학 눈높이, 구몬, 재능 뭐가 좋아요?"	... 제가 수학공부 안하긴 했지만;; 그래서 이제 수학 학습지도 시작하려고... 나온 수학 학습지 구몬 눈높이 재능 중에 뭐가 좋나요? 여러개 해 보신 분 경험... 선수학습으로 I단계(중3과정)을 공부하고 있습니다. 구몬은 처음부터... 
수학여행을 가는 두근두근 초등학생입니다+_+	"... 저는 평범한 옷이 좋아요~~^ ^ 5. 수학여행가서 재밌게 노는 방법좀..헤헤 6. 수학여행을 경주로 가는데요, 가서 어디어디 돌아다녀요..? 또 TV랑 침대도 있나요? 7. 여러가지 준비물좀 써주세요.. [샴푸, 로션, 세면도구, 우의]같은거요... "
수학 고민입니다.길지만 꼭 읽어주세요	"... 음 솔직히 말하면 제가 영어도 진짜 못해서 엄청 노력해서 지금은 잘하고 있다고 선생님이 말씀하셨고 영어도 너무 재밌고 좋아요.근데 수학은 연관이 되어있잖아요 ㅠㅠㅠㅠㅠㅠㅠㅠㅠㅠ 어쩌죠 진짜 이런 질문에, 저는 항상 같은... "
제가 수학을 진짜 좋아하는데 진로를 못정하겠어요..	... 흥미는 진짜 많습니다(전체석차는 200명에 20등?정도)) 지금까지도 수학을 좋아하고 수학을 하고 싶은데 지금 나이가 중3이라 진로를 결정해야 하는 시기인 것 같아 고민을 해봣는데요.. 수학과 관련된 쪽으로 가면 무슨 직업들이 있고... 
초6 여자 수학여행>ㅁ<♥(내공30!!)	"... 2~3벌 가져가도..충분해요..편한옷이나, 에쁜옷 가지고 가도 좋아요^ ^ 2. 수학여행가서 장기자랑은 꼭 해야되요? 그다지 하고싶지는 않은데 초등학교 마지막 수학여행이라서..ㅡ,.ㅡ 꼭은 안해도 되요^^ 저는 한번도 안했거든요... "
수학여행 갈때 쓸 돈을 얼마쯤 가져가면 좋아요?	"... 제가 요번에 수학여행을 가거든요^-^ 그런데.. 얼마쯤 가져가면 좋은가요? 아, 초등학교6학년이구요, 경주로... 6학년 수학여행이면 넉넉히 가지고 가세요. 적어두 5000원 이상, 10만원 아래면 적당할 듯 하네요.(추천 10000원~40000원) 근데... "
수학여행 갈때 쓸 돈을 얼마쯤 가져가면 좋아요?	"... 제가 요번에 수학여행을 가거든요^-^ 그런데.. 얼마쯤 가져가면 좋은가요? 아, 초등학교6학년이구요, 경주로... 6학년 수학여행이면 넉넉히 가지고 가세요. 적어두 5000원 이상, 10만원 아래면 적당할 듯 하네요.(추천 10000원~40000원) 근데... "
제가 수학을 진짜 좋아하는데 진로를 못정하겠어요..	... 흥미는 진짜 많습니다(전체석차는 200명에 20등?정도)) 지금까지도 수학을 좋아하고 수학을 하고 싶은데 지금 나이가 중3이라 진로를 결정해야 하는 시기인 것 같아 고민을 해봣는데요.. 수학과 관련된 쪽으로 가면 무슨 직업들이 있고... 
대구남구 수학과외 영어과외 어디가 좋아요?	"... 대구남구수학과외 대구남구과외 찾는방법과 대구수학과외 대구영어과외... 영어 수학 학원, 단과학원, 영수 종합학원, 국어 과학 학원 전과목 또는... 영어, 수학( 수리가형, 수리나형 )은 물론 통합과학 및 과탐( 물리, 물리2, 화학... "
수학문제집 어떤게 좋아요? (중3)	"... 어떤게 좋아요?? 이제 중3 올라가는데.. 저희 수학책은 두산꺼에요... 개념원리 1학년때 풀어봤는데 좀 어려운거 같더라구요...ㅠ.ㅠ 어떤게 좋아요??? 아! 문제 많은 걸 소개해주세요.. 요점정리나, 설명은 학원에 다니니깐 별로..... "
고1 수학 인강 추천요...내공30겁니다. 빠를수록 좋아요	"... ebs 빼고 추천이요 고1수학 선행학습이라면 양용식감동수학을 추천드리고 싶네요. 일단 개념정리가 확실히 되어있고, 개념부터 심화과정까지 필요한 부분을 공부할 수 있도록 인강이 나누어져 있어 여러모로 편하고 좋아요. 교재... "
초6 여자 수학여행>ㅁ<♥(내공30!!)	"... 2~3벌 가져가도..충분해요..편한옷이나, 에쁜옷 가지고 가도 좋아요^ ^ 2. 수학여행가서 장기자랑은 꼭 해야되요? 그다지 하고싶지는 않은데 초등학교 마지막 수학여행이라서..ㅡ,.ㅡ 꼭은 안해도 되요^^ 저는 한번도 안했거든요... "
수학여행질문이요^^	... 하는 장기자랑에 따라 다르죠 ㅎㅎ 예를 들어 개그 같은 거를 하실꺼라면 파자마 (잠옷) 입으셔두 대고요 노래나 댄스 하실꺼면 후드티 입으시고 모자 쓰시구요 후드티 모자 쓰세요 그리고 바지는 편한 추리닝이 좋아요 3. 수학여행... 
용인 죽전 수학학원 영어학원 어디가 좋아요??	"... 죽전쪽에 수학학원이랑 영어학원 좋은곳있으면 추천좀 부탁드립니다  안녕하세요. 용인과외 수업을 진행하면서 학생분들의 교과목수업, 학습코칭, 입시컨설팅까지 학생분들에게 필요한 부분을 맞춰서 수업지도를 제공하는 8년경력의... "
수학 공부법 좀여!!	"... 내신은 최대한 외부의 도움 없이 스스로의 힘으로 하는게 좋아요. 수학 문제집으로는 에이급이나, 쎈, 블랙라벨, 교과서를 싹다 풀어보시면 실력이 많이 늘 꺼에요. 내신 점수가 잘 안나오신다면 저로써는 교과서를 가 외울 것... "
수학1공부법추천좀..	... 좋은거 같구여 문제 풀 때는 신사고- 나수학 이것도 할만 하고요 쎈수학도 좋긴 좋아요 아니면 블랙박스에서 나온것도 괜찮구여 보다 높은 수준을 원하신다면 고3예비 EBS 방송교재를 사보세요 이것도 꽤 난이도 높습니다 즐공이염~~~ 
수학학습지 구몬이 좋나요?? 눈높이가 좋아요?	... 제가 수학을 별로 못해서 근데 문제는 제가 제일 처음 제친구가 구몬 학습지 수학을 하는데 나보고 좀 풀어 달라는... 그에도 하필이면 수학을 해요.. 그래서 둘다 보니깐..... 항상 문제는 수학이어서 제가 그래서 공부방을... 
동탄 수학학원 추천해주세요	동탄에 있는 수학학원 알아보고 있는데 추천 좀 해주세요. 너무 빡센 곳 말고 적당한 응용 문제 풀 수 있고 좋은 선생님들 있는 학원으로 추천부탁드려요. 오산과 가까운 곳이면 더욱 좋아요. 중 3 학생입니다. 중3이면 이제... 
고1 수학공부	... 혹시 학원 안다니고 수학 공부하신 분들 조언 좀 해주실 수 있나용..?온라인과외나 인강 추천도 좋아요 공부방법좀 알려주세요.... 만 11년동안 수학강의를 하고 있어요 50점대이면 평균정도 입니다 . 개념을 꼼꼼히 정리하는게... 
수학 초고수되는 방법좀용 ㅡㅡ;;;	수학을 좋아는하는데요;; 맘처럼 쉽게안풀리네요 원리를 이해해라고들 막하시는데 하는방법도 잘모르겠고;;; 좋아는하니까 투자는 마니할수있어용 잘하는법좀 갈켜주세요  수학은 문제를 많이 풀어보는 방법밖엔 없는것 같습니다..
용산 수학과외 영어과외 어떻게 찾아보면 좋아요?	안녕하세요?^^ 용산입니다 어떻게 용산과외 찾으면 좋을 지 몰라 질문드려봐요 시간이 부족하다고도 많이하고 남들보다 이해하는 속도가 더딘 아이입니다 고1이고 용산수학과외 용산영어과외 구해보고 있습니다 도움주실 샘... 
저기... 제가여 수학여행을 가는데여 ..	"... 하지만, 자기 전에는 비누로 전체적으로 한번 씻어주시고 자는 게 좋아요^^ 지금 수학여행을 간다고 해도, 자외선이 많이 있으니까요,. 어린이용 선크림(어른용은 피부에 안좋아요) 하나 챙겨가셔서 꼭 바르세요. 요즘은 선크림이 8시간... "
정평동 수학학원 영어학원 알려주시면 좋아요	"... 정평동 수학학원 영어학원을 찾고 계셔서 답변드립니다. [학원 위치 - 경북... 영어수학학원입니다. 강의식이나 칠판식 수업이 아닌 소수정예로 5~8명의... 공부 습관까지 잡아주는 소수정예 영어수학학원입니다. 영어, 수학 주요... "
중1 수학 문제집 어떤게 좋아요?	이번에 중1 올라가는데요 수학 문제집 좋은 것 좀 추천해주세요 난이도 ★★☆☆☆ 정도..^^; 그리고 좋은 영어... 소개 좀 부탁드립니다 ^-^ 수학은요 개념원리 중학수학 3000제 추천하구요 영어는 어휘 - 뜯어먹는 중학영단어 & 숙어... 
수학교육과 생각하고있는	... 저는 공부 중에서는 수학을 가장 좋아해서 중학교 수학 교사가 어떨까 생각하고있어요 근데 수학교육과 가면 어려운 거 엄청 많이 배울 거잖아요..... 제가 사실 머리가 문과쪽에 가까운데 수학은 엄청 노력해서 잘 하게 된거거든요... 
"여자는 수학,마술이랑 축구중에 뭐를더좋아하나요?"	"일반적으로 여자는 수학,마술(magic)이랑 축구중에 뭐를더좋아하나요? 여자는 머리아픈거 싫어하나요?  여자한테 접근하시려고 하는거시면 마술이 좋긴하죠 수학은 뭐 잘하는 얘가 한둘인것도 아니고 축구도 한둘도 아니고 잘해도... "
수학학원 영어학원 급히 찾습니다.. (공부방도 좋아요)	... 청명마을영어학원 청명마을수학학원 공부방까지도 괜찮은데 잘하는곳이 있을까요? (영통)  안녕하세요 영통에서 1:1 소규모정예수업 6년차 베테랑교사 민트쌤이에요. 매번 남들이 좋다는 곳에 보내보셧는데 정작 학원교육을... 
고1 수학이 너무 어려워요;	... 사실 정석 연습문제 수준까진 아니더래도 쎈수학 B단계나 개념원리는 수능기출쪽문제만 아니고 나머지 다 풀면 수학점수 좋아요;; 수학은 생각을 많이 하는 과목이라 그런지.... 해답보단 직접 생각하는게 도움이 많이 되는.. 
수학여행에 대해서	"... 너무많거나 너무 적게들고가거나 그럴경우엔 답변해주세요 꼭 답변부탁드립니다 네 다른건없는데요 여벌옷은 되도록 이쁜거가져가야 좋아요 ^_^* 수학여행가서 즐겁게할수있는놀이는요 말뚝박기, 부르마블같은거 [ 몰래가져가셍... "
수학 공부 땜시	"... 생각해 본다면 과외도.) 저랑 나이가 동갑이시군요, 저는 개인적으로 수학을 매우 좋아 하는 편입니다. 3학년때 수학이 걱정되신다니까 하는 말인데요 수학은 연결되는 부분이 참 많은거 아시죠? 일단 1학년때 함수를 제대로 못하면... "
수학의 잘아시는여러분들께..	... 공부를 좋아 할수 잇게 또 수학을. 좋아 할수 잇게 도움이 되는 답변좀 해주세요 부탁 드려요! ㅜ_ㅜ;; <집중력 높이는 10가지 법칙> 마음이 해이해질 때는 분단위로 계획을 세우자. 보통 학생들은 계획을 세울 때 1시에서 3시까지는 수학... 
"수학, 영어, 국어가 성적이 너무 안좋아요."	"... 국어, 수학, 영어면 일주일에 제일 많이 든 과목들... 비법가르쳐드릴께요 수학 똑같은 문제집 2권사세요 한권은... 수학공책을 만들어 쓰는겁니다 . 공책에 페이지와... 또 틀리면 별표 별표가 많은만큼 어렵다는거겠죠 ^^ 수학오답노트... "
수학문제집 어떤게 좋아요? (중3)	"... 어떤게 좋아요?? 이제 중3 올라가는데.. 저희 수학책은 두산꺼에요... 개념원리 1학년때 풀어봤는데 좀 어려운거 같더라구요...ㅠ.ㅠ 어떤게 좋아요??? 아! 문제 많은 걸 소개해주세요.. 요점정리나, 설명은 학원에 다니니깐 별로.. 문제... "
안산고등수학학원 추천이요	개념설명잘해주고 빡션학원 어디 없나요 고잔 신도시쪽이면 더욱 좋아요 이과 수학이요 메스탑이 너무 문제풀이 위주로 어려워서요?? 안녕하세요~~~!!! 고잔 신도시 지역에서 클래스마다 최대 정원 8명 정도의 학생들에게 국어 영어... 
수학여행에 대하여(포시즌 유스호스텔)	... 돈은 어느정도 가져오는게 좋아요? 5. 수학여행에 휴대폰 못가져오게 해요? 6. 밤은 언제쯤에 새는게 좋은가요? 7. 수학여행의 필수품은 무엇인가요? 8. 교관들은 어디에서 자나요? 9. 학생들은 어디에서 자나요? 10. 성실하고 신뢰성... 
"수학여행에 대해서,,,,,,,,"	... 제가 서울로 수학여행을 가는 데요...서울로 가면 좋아요??? 4. 수학여행에 가면 장기자랑이 있어요??? 5. 교관 있어요???? 6. 휴식 시간이 많아요????? 7. 취침 시간은 언제고 기상 시간은 언제예요????? 좀 많죠......죄송해요.....그래두 하나... 
수학에 대해 질문을 할게요 .....	"... 그중에서도 수학이 가장 좋아요 ,,,, 저는 학원, 학교에서 인정받을 정도로 수학을 합니다 ... (자랑이 아니라 제 성적 예기한거로 알아주세요) 그런데 .. 막상 대회 같은 곳 나가면 수학할때 기본 산수 , 계산능력등이 저하되는 것을... "
고1 수학인강 추천	... 인강에 맞는 교재로 인강을 듣는게 제일 좋아요. 그리고 수학은 학생의 스타일과 현재 상태를 명확히 알고 선택을 하셔야 해요. 인강은 학생들이 이해를 했는지 선생님이 확인을 못합니다. 그래서 이해를 한다는 전제하에 선생님이... 
용인 죽전 수학학원 영어학원 어디가 좋아요??	"... 죽전쪽에 수학학원이랑 영어학원 좋은곳있으면 추천좀 부탁드립니다  기초실력이 부족하다면, 학생의 스타일을 명확히 알고 선택을 하셔야 해요. 학원의 장점은 빠른 진도나가기가 있죠. 하지만 단점은 아무리 소수정예라... "
수학여행에 관해서^^	... 앞머리는 깠고...) 아님 헤어 드라이어기를 들고 가는 것이 더 좋아요? 5.수학여행에서 애들이 주로 밤을 새나요? 질문이 쫌 많죠...ㅠ 그래도 답변좀 해주세요 1.수학여행때 짐가방은 케리어가 낫나요??(2박 3일이에요) 캐리어가 좋긴... 
수학 재미있게 하는방법	... 그냥 수학을 좋아하는 한사람으로서..(어디까지나 좋아하는거임..;;) 수학을 힘들다고 하기에..ㅠ.ㅠ 조금 속상한 맘에 글올린거니까 채택같은거 안해주셔두 되요..-ㅁ-;;(채택할만한 글이 못된다는것쯤은 알구 있어요..ㅎㅎ;;) 그럼... 
수학여행 옷 추천좀 해주세요!	... 저희가 이번에 수학여행을 가는데 도저히 옷을 못 고르겠어요..ㅠㅠ 제가 선택장애가 있어서 옷 고르는데 한참... 키가 커보이는 옷이면 더 좋아요!)  일단 상의는 이건 무조건 구매하셔야할듯하네용ㅎ 활용도가 굉장히 좋아요!... 
수학의 정석 책 어떤가요?	"... 수능부터 내신,논술 등 시험 종류를 가리지 않고 수학 실력 자체를 늘리기에 좋아요. 수학의 정석은 원래 수능을 대비하기 위해 만들어진 문제집이라기 보다는, 수학의 원리를 익히기 위해 만들어진 기본서라는 것을 기억해야... "
수학 용어 말하기 삼각비에 대해 2분정도 갈략하게... 	"수학 용어 말하기 삼각비에 대해 2분정도 갈략하게 적어주세요 예를 들어주는것도 좋아요 제발요 ㅠㅠㅠㅠㅠ 내공 100 삼각비에는 대표적으로 sin(싸인), cos(코싸인), tan(탄젠트)가 있습니다. 중학교 때는 이렇게 세 개만... "
제주 노형동이나 연동 근처 수학학원 영어학원 있나요?... 	"... 영어,수학 찾기는 한데 자세한건 다른과목도 상담해봐야할듯해요 기초가 영부족하고 혼자서 공부도 안하려하네요.... 질문자님 노형동 영어학원 수학학원 문의 주셨군요 노형동 밀착형 소수정예 전과목 학원 추천드려요 모두들... "
영어학원 수학학원 청송마을 쪽도 좋고 공부방도 좋아요	아이 엄마에요 저는 청송마을 살고 있어요 그런데 고창마을 까지 공부방 또는 영어학원 수학학원 보내볼까 하는데 주변에 잘하는곳이 있을까요?  안녕하세요 장기동에서 1:1 소규모정예수업 6년차 베테랑교사 민트쌤이에요. 매번... 
수학공부할때 뭐가 좋아요?	수학공부할때 뭐가 좋아요?  수학의 정석!!~ 개념원리.
수학 추천 도서	... 아니면 수학 추천 도서 이름이라도 알려주세요.. 중3이 읽을 정도로요.. 답변 부탁 드립니다... 1. 중3 재밌는 수학. 2. 수학귀신 3. 수학이 좋아요 4. 수학이야기 다 좋은 책들입니다..^^ 
초등학생 수학 문제집은 뭐가 좋아요?	... 우공비? 이런 문제집 하게 할까요? 어떤 문제집으로 할지 잘 모르겠어요ㅠㅠ 추천 부탁드려요 저도 수학 풀때 쎈으로 풀었습니다! 저도 저희 동생 가리킬때 역시 쎈으로 가르켰구요!!! 
"서울대 수학교육과, 서울교대 선택"	"... 내신이 좋아 비교과로 수학 동아리활동, 교육활동을 해서 서울대 수학교육과 합격가능성 높고 합격 기다리고 있어요~ 중소도시 일반 인문계고등학교 이과로 수학은 3년내 1등하지만 전국적으로 보면 잘 하는 편이 아니에요. 수능... "
수학때문에 정신병이 걸릴거같아요	... 시원하게 수학 드랍하시고 자기가 조금이라도 행복하게 할수 있는 공부를 해보세요! 수학때문에 죽고싶을 지경이라면 수학을 드랍하는게 좋아요 고작 수학 때문에 죽기에는 너무 짜증나잖아요
수학관련 과학주제탐구 주제 정해주세여	수학교육과 진학을 꿈꾸는 고2입니당 과학탐구주제를 정해야하는데 수학관련으로 어떻게 주제를 잡으면 좋을지 어렵네용 정해주세염 하하 실험을 해도 되고 논문 위주로 보는 주제도 다 좋아영 몇가지 주제를 정해드리자면 1. 소수와... 
6학년 수학여행!	... 자아~ 이제 질문 1.수학여행때 필요한 준비물!(사진잇으시면 더더욱 좋아요!) 2.수학여행 코디!(이것도 사진포함해주시면 좋아요)< 참고로 제가 키가 완전작아요 138정도?> 3 설악워터피아에 반바지랑 반팔티 야구모자 쓰거나 입고... 
중고등 수학 선생님	고 1인데요 꿈이 수학선생님이 되는거에요 제가 지금 성적이 아주 안좋아요.. 수학은 2등급 3등급에서 잇고.. 다른건 엉망 이죠... 4등급 5등급 까지 잇을정도로.. 심해요 ㅜㅜ 아직 2학기 기말 고사 하나가 잇어요 2학기 기말부터 잘하면... 
고1수학 뭐가 괜찮나요?	... 개념정리 정말 확실하게 해주고 공식을 굳이 외우지 않아도 개념을 이해하면 적용할 수 있게 그리고 문제풀이도 다양한 시각으로 보여주니까 전준홍샘 수학인강이 좋아요. ebs에서 수리 강의도 했으니까 그런 면도 괜찮구요... 
수학이랑 영어에 대해서 고1임	"... 많은 조언 부탁드립니다 ㅠㅠ 수학은 좋아하시는데. 영어는 딥따. 시러하신당. 어쩌낭.. 수학과 영어는 꼭, 해야할. 필수과목입니다.. 특히 영어는 더죠. 저는 영어와 수학 딥따. 좋아합니다. 어캐해서 좋아졌냐규요ㅣ';? 전. 영어를... "
대구 침산동 수학학원 영어학원 침산네거리 근처면 좋아요	침산동수학학원 찾으려고 해요. 발품을 팔아보려고는 하는데 마음에 들면 바로 하려구요 침산동영어학원 어디가 괜챃을까요?  https://m.blog.naver.com/exxrx 침산동 핫플학원입니다
중등 수학 난이도질문 40	"... 개념편으로 개념 정리를 하면서 처음에는 쉬운 문제 위주로 풀어보며 개념을 익히고, 유형편에 있는 다양한 문제들을 풀면서 심화 문제에 대한 연습을 하면 좋아요~ 수학은 혼자서 공부 하기 어려운 과목중 하나여서 문제만으로... "
수학의 정석이.....	"... 오, 좋아요좋아 ㅋㅋㅋ 수학의정석으로 개념이나 유형파악하시고 문제위주 문제집으로 풀어보시면 좋죠 ㅎ 개인적으로 SSEN 추천해요 ㅎ A / B / C 난이도가 나눠져잇어서 좋아요 ㅎ Q.수학의 정석 고1기본편 이미지좀 보여주세요. A.... "
공주사대 수학교육과	"... 제가 좋아 하는 과목이 수학 사회(지리,역사 o 정치,외교,사회,법 x ) 과학 조금 좋고.... 국어 영어를 싫은데 공주 사대 수학 교육과를 가려면 이과를 가야 겠죠?? 3. 제가 충남 사는데 꼭 공주 사대 가야 하나요?? 공주 사대 셀것 같아서..... "
수학여행 갑니다	... 친구들이 좋아 할만 한것좀 추천 해주세요 ㅠㅠㅠ 저의가 안뽑히면 여자 애들이 민속촌 민속촌 거립니다ㅠ 수학여행을 가시는군요. 여수는 많은 관광명소가 있는 곳이에요. 여수에서 가볼만한 곳은 다음과 같습니다.... 
수학 선행법	"... 만들면 좋아요. 수학 개념노트란, 교과서의 개념과 교과서 외 각종 유용한 개념들을 함께 정리하는것도 좋은 방법입니다. 학교 프린트나 인강 선생님이 알려주신 내용 등을 자기만의 방식으로 정리하면 좋은데, 정리하는 과정에서... "
수학여행때 장기자랑 하려는데 어떤 노래가 좋아요 ??	... 수학여행을 가는데~ 장기자랑을 하거든요 ? 장기자랑 하는거니까 당연히 춤 아니면 노래겠지요 ... 어떤 노래가... 그리고수학여행가셔서놀려면 버스안에서오질라게주무셔야됩니다 ^ ^ [참고로경험담]... 
수학교육과 생각하고있는	"... 자세""와 ""수학을 좋아하는 마음"" 이 두 가지를 가지고 있다면 수학을 잘하게 될 수 있을거라고 믿어요!! 문제는 이 두 가지 중 어느 하나라도 갖추기가 정말 힘들다는 건데, 우리 학생분께서는 이 두 가지를 모두 충족하고 계신 것... "
수학을 과외로만 돌리다가 다닐만한 판	수학을 과외로만 돌리다가 다닐만한 판서반 강의 찾고있어요~ 학생이 수학에 흥미가 있어서 여태까지 과외로만... 대치동에 학원이 워낙 많다보니 다 좋아보이네요~~~ 사실 대형학원 가면 평타 이상은 칠거같은데 너무 또 대형에서 여럿이... 
수학시험 30점..많이 심각한가요?	"... 질문???? Q.성적 잘 오르는방법(실제 후기도 좋아요) Q.수학 문제집 추천! (기초부터 시작해서 추천부탁 드려요!),(강의 추천도 좋아욥) Q.수학에 유용한 꿀팁? 알려주시면 감사하겠습니다ㅠ  예비중2인 상황에서 중2 과정 수학... "
숨마쿰라우데/ 수학의 정석/ 바이블 중 추천해주세요	"... 10나 문제집을 사려고하는데요( 역시나 독학 으로 할 예정입니다) 제목처럼 숨마쿰라우데가 좋아요, 수학의 정석(기본)이 좋아요, 바이블이 좋아요? 수학의 정석은 아직 한번도 풀어본 적이없구요, 10가에서는 그냥 바이블 하나랑... "
중등수학문제집 어떤 게 좋아요?	중등수학문제집 어떤 게 좋아요? 수학 개념쪽 같은 경우에는 이해가 되었는데 유형 부분이 아직 이해가 잘 안돼서 수학 유형 쪽으로 공부를 더 해야 될 것 같은데 어떤 중등수학문제집으로 풀어야 할지 감이 안 오네요 유형 쪽으로 공부할... 
저 6학년인데여 수학여행 갈때 어떤 가방 들고 게 좋아... 	"... 수학여행 갈때 무슨가방 들고 가는 것이 좋아여?? 음... 캐리어, 비닐가방, 배낭 가방 중에서요... 빠른 답변 부탁 드릴께요~^^ 욕설 금지!! 이상한 글올리면 신고 합니다!! 바르고 고운 글만 써주세요~^^ 내공 많이 드릴께요~^^  저두 내일... "
(중3) 수학문제집 뭐가 좋아요?	... 내신대비로 할껀데 문제좀 많고 설명은 적당하게 있는거.. 3천제 절대 사절입니다.  수학 문제집 하면 부동의 1위인 정석과 디딤돌 개념 원리 강추 드립니다.. 이 두 문제집만 푸시면 셤 걱정을 없으실 겁니다..
대치동 수학학원 추천요~	... 대치동에 개념의힘 이란 수학학원 좋아요? 질문2. 개념의힘에 대해 설명해주세요 질문3. 다른 학원 추천요~( 페르마나 외고전문 학원 말고 고등부중심인데 추천해주세요) 학원 추천 하실떄 전화번호랑 그 학원이 어떤학원인지... 
수학을잘하게 할려면≥ㅁ≤	... 열심히 공부를 해도 점수가 않좋아요... 수학 잘하는 님들... 좀 비법좀 갈켜주세요..  수학은 우선 원리가 중요합니다.. 만약 시험이 코 앞으로 닥쳐왔다면 그냥 푸는 방법만 공부해야 겠지만 정말 공부를 할려면 아무리 쉬운 문제라도... 
체크체크수학과쎈수학중무엇이더좋아요..?	"수학문제집이요... 8-나 과정을 풀건데.. 1,쎈수학과 체크체크 수학 중 해설이 더 잘되어 있는것은 어떤건가요?? 2,이 두... 신중하게 판단해서 쓴 답변 부탁드려요.정확하고 자세하게 써주세요♡♡  체크 수학은 들어본 적이 없기에 그리... "
수학의 잘아시는여러분들께..	... 공부를 좋아 할수 잇게 또 수학을. 좋아 할수 잇게 도움이 되는 답변좀 해주세요 부탁 드려요! ㅜ_ㅜ;; 수학의 재미... 혹시 퍼즐같은거 좋아하시나요? 수수께끼라든가? 그런거 풀때는 정말 머리아프고 힘들지만 풀리는 순간의 그 기쁨!... 
예비 高1 수학공부 질문	"... 그리고 수학이란 과목을 '좋아'해야 하고, 선생님도 '좋아'해야 합니다. 좋아하지 않으면 잘하시는 거? 안타깝지만 기대하지 마십시오. 좋아해야합니다. 흥미가 없으면 언젠가 굴러 떨어집니다. 그리고 기초부터 철저히 하십시오. 먼저... "
대치동 수학학원 추천요~	... 대치동에 개념의힘 이란 수학학원 좋아요? 질문2. 개념의힘에 대해 설명해주세요 질문3. 다른 학원 추천요~( 페르마나 외고전문 학원 말고 고등부중심인데 추천해주세요) 학원 추천 하실떄 전화번호랑 그 학원이 어떤학원인지... 
중학교 수학 심화 문제집 추천	"... 수학에 자신이 있거나 선행 또는 창의력 문제들을 많이 다뤄봤다면 최상위 수학으로 바로 넘어가셔도 되지만 그게 아니라면 천천히 일품부터 하시는게 좋아보입니다. 2. 내신이 특출나게 어려운 학교가 아니라면 쏀, 일품 정도면... "
중1 수학 공부를 시키려고 하는데 뭐가 좋아요???	... 중1 수학 공부 방법에 대한 질문 남겨주셨네요. 학습지와 학원으로 공부를 했었다면 중학교 수학은 일대일 과외로 시작해보는 건 어떨까요? 수학은 연계학습이라 많이들 말하잖아요. 중1 수학 개념이 제대로 잡혀야 수학 공부를... 
수학인강 들어보려구 하는데염.. 수학인강 어떤게 좋아요?	... 제가 수리 논술인강듣고 강의에 반해서 들었던 수학인강인데요 난이도로 비교하면 손광균선생님 수학인강이 잘 맞을꺼 같아요 ㅋㅋ 강의가 차분하고 교재 구성이 좋아서 복습 하기도 편하고 ㅋㅋ 쉽게 말해서 강의에 성의가... 
수학과외선생님 추천해주세요 아니면 상인동도 좋아요	... 아니면 근처에 상인동과외도 좋아요 예비고등학생이라서 선행학습을 하고싶어요. 잘 가르치시는 선생님 있으면... 초4 초5 초6 중1 중2 중3 고1 고1 고3 상인동영어과외 상인동수학과외 대천동영어과외 대천동수학과외를 하고 있습니다. 
수학여행 이요~!!!	"... 수학여행갈때 과자,간식등은 음료수나물 종류 빼곤 가져가시는게좋아요 수학여행장소에선 정가대로 받는데다 더 비싸게치는경우도있거든요 뭐..돈많으시다면 거기서 사드셔두되구요 세면도구 (비누,치약,칫솔,핸드크림이나로션)... "
삼송 수학학원 또는 과학학원 신원마을 근처에 다닐만한... 	북삼송 쪽이라면 더 좋구요 삼송수학학원 아직 다녀본 적이 없어서 어디로 보낼지 모르겠어요 꼭 단과로 한과목씩 아니더라도 삼송수학과학학원 함께 가르치는 곳 있어도 좋아요 원장님 선생님들 친절하시고 삼송과학학원 전문성있게... 
중등 수학이 어려워요	"... 만들면 좋아요. 수학 개념노트란, 교과서의 개념과 교과서 외 각종 유용한 개념들을 함께 정리하는것도 좋은 방법입니다. 학교 프린트나 인강 선생님이 알려주신 내용 등을 자기만의 방식으로 정리하면 좋은데, 정리하는 과정에서... "
중3 수학 고등 예습	중3인데 중3수학 풀면 안되고 꼭 고등학교 수학 미리 예습하고 있어야 나중에 공부 잘 할 수 이ㅆ나요 전 아직 중3... 인강 + 학원 or 인강 + 개인과외병행하는게좋아요. 실력을 올리는데 효과적인 순서는 1:1 개인과외 > 학원 > 인강 독학이... 
중1수학문제집 추천★	... 문제많이하려면 좋아요 하이레벨: 어려운것쪽으로 해보시려면 이거사세요 에이급수학: 어렵긴해도 좋아요~ 투탑: 진도용으로 좋아요 (아차! 사회맨첨에 진도용하려면 투탑하세요~) 에이급원리수학: 에이급수학하기직전에 좋아요 
수학 설문조사	제가 국어시간에 자료조사를 조금 해야 하는데 학생들을 중심으로 한 '수학을 좋아하는가?' '수학을 왜 싫어하는가?' '수학을 언제 포기했냐'라는 3가지 설문조사가 필요한데요 오늘안에 구해주세요ㅠㅠ 그리고 유튜브에 수학을 배우는... 
수학만 잘하면 어떤대학가는게 좋나요??	... 근데 수학만은..좋아 하기두 하지만.. 점수도 잘나와요.. 그래서 그런데 .. 수학만 잘할경우.. 어떤대학에서 어느학과로 가야하나요?? 제 꿈은.. 수학선생님되는게 꿈이거든요............  수학만 잘해선 답이없는데 ;
인천 중구 신흥동. 미추홀구 용현5동쪽. 고1 수학과외.	"... 수학과외 하고 싶은데. 주말에요. 대학생 선생님도 좋아요. 어디서 찾아야 하나요?  인천중구 신흥동 미추홀구 용현5동 고1수학과외 찾으시네요~ 인천 전지역 일대일 수준맞춤 수업하고 있는 전문수학과외 교사입니다. 신흥동, 용현동... "
수학의 정석 수1 좋아요?	... 지금까지는 개념원리->수학거미 이렇게 해왔습니다. 1.10-하와 수1 병행해도... 수1이라고 하시면 고2수학을 말씀하시는 것 같은데 선행 학습으로 하기에는... (무료강의면 더 좋고..) 저 같은 경우에는 수학의 유형이 여러가지가... 
중1 수학	"... 수업시간에 집중해서 열심히 듣는 건 당연히 해야하는 거고요 무조건 문제를 꾸준히 많이 풀어보는 것이 좋아요. 수학의 경우 원리를 이해하는 것을 넘어 응용까지 잘 할 수 있어야 성적이 잘 나오는 과목이기 때문에, 수업시간에... "
일산후곡에 있는 수학학원	후곡 수학하권 다닐려고그러는데 밑에중에서 어디가 좋아요? 1.시매쓰 2.페르마 2.와이즈만 또 좋은데있으면 추천졈 https://naver.me/xhnsLRVQ 수학은 공식과 기초개념을 더욱 확실하게 잡아가야 하는 과목입니다 일산수학학원 후곡수학학원... 
중1수학 문제집?!?!	... 수학은 공식을 외우는 것두 중요하지만 수학공부는 일단 문제를 많이 접해보시는 것이 좋아여^^ 수학문제를 많이 풀어보시기에 좋은책은 2000제 에요^^ 이거 두개 사셔서 공부하실때 이렇게 해 보세여^^ ※ 예로 1단원 집합을... 
고등학교 수학에 대해서`	"... - 문과는 수학하는거 자체가 좋아요 수학안하면 솔직히 좋은대학은 못가구요 대학별로 입시제도가 달라서 수2하면 좋은대학도있고 안그런대학도잇고요 ○지금 고등학교 수학 新바이블을 샀습니다, 고등학교에서 다른 좋은... "
수학 고민	"... 말이 교과서지 그것만 공부하면 위험해요!(천재가 아닌 이상) 다른 문제집, 한 2권 정도(1권도 좋아요)? 좋은 수학책을 같이 교과서와 나가면 좋아요. 답지도 웬만하면 괜찮으니 큰 문제 없을 거예요! 3. 정확성이 스피드보다 더... "
수학 중학생인터넷강의 수강	... 피클도 좋아요 수학은 신사고에서 출판되는 쎈수학을 많이 쓰잖아요? 신사고피클은 쎈수학을 만드는 회사에서 운영하는 인터넷강의 사이트에요~ A/B/C 모든 단계의 문제를 풀어준다고 하니까 도움이 많이 될 거에요 요즘 비상 교재로... 
수학 학원이나 과외하면 좋아여?	전 학교학원 안댕기고 혼자서 공부하는 고3인데요 외국엘 나갔다와서 지금 진도가 수1 수열하고있습니다 (이과ㅡ) 진도는 실력정석으로 나가고 문제집은 특작같은거 풀어봤는데 혼자서 다 할만하거든요 그런데 중요한건 혼자서 하니까... 
(중3) 수학문제집 뭐가 좋아요?	학원에 제가 늦게들가서 이차함수부터 배웠거든요? 그래서 인수분해나 이차방정식 이런건 지금 다 할수 있는데요. 문제는 제곱근입니다. 루트 8= 2루트2 뭐 이런거 기본적 다 아는데요. 암튼 선행을 제대로 안하고 가서 학교 시험때 좀... 
고1 수학2 풍산자랑 쎈 라이트 중에 뭐가 더 좋아요?... 	고1 수학2 풍산자랑 쎈 라이트 중에 뭐가 더 좋아요? 다양한 문제 많은걸로 문제많은신걸로 할려면 쎈이 나을것 같습니다 저는 지금 풍산자로 공부하는데 풍산자는 개념서에서는 최고입니다 개념서이다보니까 문제가 많기보다는... 
학원 수학선생님이 넘 좋아요 ㅠㅠ	전 고 3되는 여학생이구요 제가 학원에서 수학을 배우고 있거든요 근데 수학선생님이 너무 좋아요ㅠ 선생님으로 좋은게 아니라 이성으로서 좋아요 그 쌤이 자상하면서도 남자답고 웃기고 장난기 많고 애들한테도 인기많고 약간... 
예스셈과 눈높이 수학	"... (하나 알아주시는게 좋아요^^; 수학은 초,중,고등학교, 대학교, 대학원 까지 수학 안배우는데가 없습니다! 어떤 학과를 가도 수학을 안배우는 학과는 없어요!) 그때 수학이 재미없고 어렵다고 피하거나 심하면 수학을 포기하는 사람도... "
고3 수학 노베	... 쎈이 좋아요!! 화이팅! [포마스쿨 수학/영어 1등급 커리큘럼 안내] 월3만원 포마스쿨 멤버십 회원가입으로 이제 누구나 수학/영어 1등급 학습이 가능합니다. 학원이나 과외수업과 병행해서 멤버십을 이용해도 좋고 자기주도학습이... 
초6 여자 수학여행>ㅁ<♥(내공30!!)	"... 저는 평범한 스탈이 좋아여~~~^ㅁ^ 5. 수학여행가서 재밌게 노는 방법좀..ㅎㅎ 6. 수학여행때 할 머리스타일 갈켜주세요~ 저는 지금 샤기했구요, 머리길이는 어깨 조금 넘어용~>ㅁ< 7. 수학여행을 경주로 가는데요, 가서 어디어디... "
겨울방학때 수학1 어디까지 해놓는 게 좋아요?	"... 수학1 어디까지 해놓는게 좋아요? 저는 참고로 이과지망생입니다.  이과 지망이시라면.. 음.. 제도가 바뀌어서 확실치 않은데 공통수학, 수1, 수2, 그리고 선택을 배우겠죠? 그러면.. 빡세게.. 정말 빡세게 수1을 끝내는 걸 목표로... "
"장기동에 수학과외,영어과외찾아요 공부방도 좋아요"	"... 영어과외,수학과외 선생님 찾아요 초등생은 공부방 보내도 괜찮은데 수학 공부를 잘하는게 아니라서 초등전문으로 하는 수학과외 선생님 있다면 같이 지도... 오래동안 수학과외,영어과외 수업해온 파트너과외 입니다... "
고1 수학문제집과 수학에 관하여 =_=	... 그냥 학원에서 많이쓰고 좋다는거좀 추천해주세요 참고로 저는 수학 최저 50점 최고 80점이구요 수학은 좋아는하지만 잘하지는 못합니다  개념이해하고 문제 많이 푸는거에 추천 그리고 문제집은 메가스터디꺼 한번 해보세요 우리... 
중1수학	... 수학의 신 고난도 문제집입니다 저는 수박씨 강의를 듣고 있어요 (참고로 예비중3 입니다) 설명도 잘 하시구 반복해서 들을 수 있으니까 좋아요^^ 수학을 잘 하는 노하우? 그냥 문제 많이 풀어보고.. 이해안가면 계속 질문하고..... 
"송파, 대치 수학학원 추천해주세요"	... 학교내신도 수학이 제일 안좋아요... 고1내용은 애가 선행을 했었어서 기본은 알고 고등학교에 입학했는데 애가 사춘기가 온건지.. 수학을 거의 놓기 시작해서 학원도 끊고 그래서 수1은 아직 배우지도 않았습니다. 고등학교 1학년... 
국어 수학과외고 빠른시일내에 시작 할수있으면 좋아요.	"국어하고 수학과외를 방문해서 가르치시는 선생님을 구하는데 우리 아이가... 부천 중동 국어 수학과외 영어과외 알아보셔서 답변드립니다. 부천에서... 밀착형 소수정예 영/수학원이며, 영어선생님 수학선생님 전담강사가... "
전요. 수학을 제일 좋아하는데요..	... 아주 잘하지는 않지만 수학시간이 제일 좋고 수학샘들도 좋고 수학자도 좋고 수학사도 좋아요. 좋아하니까 관심이 생긴다는게 정답일지도 모르겠네요. 그런데요. 이런 말 친구들한테 하면 좀 이상한 애로 보는 것같은 느낌이 들어요.... 
중3 수학문제집추천	"... 그리고, 국어한권으로 끝내기는 굳이 말하자면 많은 문제가 수록되어 풀기 좋아요 . ▶수학 교재:[투탑수학],[개념원리 중학수학],[신사고 파란수학],[하이레벨] 학습방법&경험담:수학은 [투탑수학]과 [개념원리 중학수학] 이 있는데... "
빨리 답변부탁해요 중1수학 풀이만이라도 좋아요	"연속한 세 자연수의 합이 96일 때, 가장 작은 자연수를 x라고 하여 방정식을 세워라. a,b두 물통에 물이 각각 48L,12L 들어 있다. A에서B로 몇 L의 물을 옮기면 A의 물이B의 물의 3배가 되겠는가? 십의 자리의 숫자가 4인 두 자리의... "
대치동 수학학원 고등교육?	... 조용하면서 잘 배울수있는 그런 대치동 수학학원이 좋아요 저는.. 대치동 수학학원 가게되면 공부습관도 들이고싶구요. 음 대치동 수학학원 가서 상담도 받아보고 대치동 수학학원 어떤지 보고싶고 여러모로 대치동 수학학원... 
수능수학문제집 어떤게 좋아요?	요즘 공부하면서 수학을 어떻게해야하나 생각이 들어요. 이과인데 수학 안나오면...안되겠죠. 이과생들 어떤 수능수학문제집 풀고있는지 추천좀여.. 수능수학문제집이라도 많이 풀면 좀 나아지리라 믿고 지금부터 시작해보려고요ㅠㅠ... 
초등학생 수학 문제집은 뭐가 좋아요?	... 수학 개념과 심화문제를 함께 풀수 있어서 교과학습 보충 학습하기 좋았어요. 디딤돌은 문제집이 세분화 되어... 만점왕을 한번 해봤다면 디딤돌 초등수학 기본+유형이나 기본+응용으로 배운 부분 다시 학습해 보는것도 괜찮은거... 
"송파, 대치 수학학원 추천해주세요"	... 학교내신도 수학이 제일 안좋아요... 고1내용은 애가 선행을 했었어서 기본은 알고 고등학교에 입학했는데 애가 사춘기가 온건지.. 수학을 거의 놓기 시작해서 학원도 끊고 그래서 수1은 아직 배우지도 않았습니다. 고등학교 1학년... 
수학동화 선택! 도와주세요..	... 7가지 영역별로 되어있어 꼬마 어린이 같이 읽어주면 좋아요. 수학동화는 교구 있는걸로 고르세요. 아이들은 손으로 조작하고 만져보면서 더 이해할수 있고 특히 도형같은건 손으로 만들어 보는게 중요해요. 수학동화나 과학그림책은... 
최상위 수학 라이트	최상위 수학 라이트는 내신에 좋아요? 좋다면 약 몇점 정도 받나요?  최상위 라이트 문제 좋아요!! 열심히만 푼다면( 두세번 반복하는 식의 학습) 내신 80점은 거뜬히 나올겁니다! 킬링문제들까지 맞으면 더 잘나올거구요
전요. 수학을 제일 좋아하는데요..	... 아주 잘하지는 않지만 수학시간이 제일 좋고 수학샘들도 좋고 수학자도 좋고 수학사도 좋아요. 좋아하니까 관심이 생긴다는게 정답일지도 모르겠네요. 그런데요. 이런 말 친구들한테 하면 좀 이상한 애로 보는 것같은 느낌이 들어요.... 
학원 수학선생님이 넘 좋아요 ㅠㅠ	전 고 3되는 여학생이구요 제가 학원에서 수학을 배우고 있거든요 근데 수학선생님이 너무 좋아요ㅠ 선생님으로 좋은게 아니라 이성으로서 좋아요 그 쌤이 자상하면서도 남자답고 웃기고 장난기 많고 애들한테도 인기많고 약간 부인한테... 
"수학, 영어 기초가 전혀 없는 대학생이 질문드립니다 ㅠㅠ"	... 다만 스터디 그룹을 님이 만드실거면...님하고 비슷한 사람하고 만드시 마시고 님보다 잘하는 사람하고 같이 공부하게 만드는게 좋아요... 2. 수학을 기초부터 다시 시작해야되는데 중학교 1학년 과정부터 시작하는게 적합할지... 
수학학원 끊어야 할까요?	"... (저같은 경우엔 의지력이 약해서 인터넷강의 들으면서 딴짓도 꽤 많이 하거든요ㅠㅜ) 아님 과외를 해보시는것도 좋아요 수학같은건 과외하면 성적 팍 올라가는경우도 많아요. 저도 그런케이스=,.-;; 인터넷강의 듣다가 의지력이 약해서... "
고등학교 1학년 수학 영어 국어 사화 과학 문제집... 	... (자습서는 안되요~) 가격도 아시면 적어주시면 감사하겠습니다 ^^ 하나씩 말고 여러개 추천해주시면 더 좋아요 >_< 수학 자세히 알려주세요 @_@ 감사합니다!  국어는 완자나 한권으로끝내기 좋아요 정리가 잘되있구요 수학은 개념원리가... 
수포자 수학 다시 시작하는 방법	"... 기초부터 다시 학습하기 어떤 학년부터 공부해야 하는지 보다는, 기초적인 내용부터 차근차근 학습해나가는 것이 좋아요. 초등학교 때 배웠던 내용부터 시작해서 전반적인 기초 수학 지식을 다시 쌓아나가면서, 학년에 맞게... "
예비고 수학공부법	... 에요...비타에듀에서 하는거구요. 그런 후... 수학교과서 3번 이상 반복해서 풀어보시구요.. 그 후에.. 쎈수학을 하심 좋아요... 이것 저것 다 한다고 좋은게 아니니까.. 이런 과정을 함 해보세요.. 분명 도움이 될겁니다. ^^
수능 벼락치기(영어)와 능률영어// 인터넷 수학 (내공20)	... EBS 수능 초이스 뭐가 젤 좋아요? 수학 마지막입니다..^^ 학원 안 다니고 인터넷을만 하면 안될까요? 1. 한석현 2. 박장준(공명) 소순영 뭐가 젤 좋아요? 답변 부탁드려요 아! 수학 과외 할 때 의대생이 좋나요 안그러면 수학 전공자가 더... 
마두동 백마마을쪽 쪽집게로 알려주는 영어수학 과학... 	백마공원쪽으로 방문하시는 쌤 있으시면 방문도 좋아요~지금 다니는 학원을 바꿔보려고 하는데 종합학원을 다녔더니... 일산수학과외 일산국어과외 마두동영어과외 마두동수학과외 마두동국어과외 백마마을영어과외 백마마을수학과외... 
수학은어떻게해야잘할수있어요?	"... ㅎ 아, 그리고 방학되시면 독서 미친듯이 하는것도 좋아요 수학잘하고싶다고 수학책을 읽기보다는 소설책이나 기행문, 가끔은 수필도 읽어보시면 좋아요 공부란게 그 한 분야만 잘해서는 안되고, 골고루 지식이 있어야 어떤 분야... "
중1 1학기 수학문제집	"... 개념편으로 개념 정리를 하면서 처음에는 쉬운 문제 위주로 풀어보며 개념을 익히고, 유형편에 있는 다양한 문제들을 풀면서 심화 문제에 대한 연습을 하면 좋아요~ 수학 문제집 개념플러스 유형을 만든 비상 교육이... "
독학할때 수학의정석이 좋아요 개념원리가 좋아요?	... 그런데 수학 공부를 어떻게할지가 고민이더군요 그래서 일단은 메가스터디 신승범 선생님 강의를 듣고있는데... 개념원리 수학의 정석 둘중 어느게 더 좋을까요? 참고로 이번 11월 모의고사 수리 3등급 나왔어요  병행도서라면..... 
"산곡고 수학,영어 경력있으시고 내신관리 해주실 샘... "	"안녕하세요 산곡고 2학년 아들 둔 엄마인데 수학,영어를 중점으로 내신관리 해주실 방문선생님찾고있어요... 산곡고 영어 수학 내신대비에 확실한 도움을 드리고 있습니다. 1:1 맞춤지도 방식으로 꼼꼼하고 체계적인 내신관리을... "
수학경시대회 인터넷 시험있나요??	... 인터넷 시험도 좋아요!!  안녕하세요. 콘테스트코리아입니다. 수학경시대회 중에서 현재 접수중인 대회와 개인적으로 참가하는 대회입니다. 참고해 보세요. 교육?학문?논문 제20회 전국 푸르넷 수학경시대회 0... 
휴.. 수학공부하는것 때매 짜증나요	"... 재능이 좋아요 수학 3,3000 영어35000 이니까 정말 싸죠? 학원에서 하는것보다 원리도 빨리 깨닫고 쉬워서 좋고 재미를 느낀답니다 신경질 날 이유도 없고~정말 좋아여 그리고 고3부터 되면 자기 스스로 공부해야되죠 학원간다해서... "
중1-1수학 공부	... 개념서지만 문제도 몇개씩 들어있어서 좋아요!! 수학은 개념잡고 문제위주로 풀면 되는것같아요. 저는 학원을 안다니는데 이 책 설명이 엄청 자세히나와있어서 이해하기 좋았어요 문제위주로 돼있는건 아무래도 제일 유명한 <쎈... 
수학여행 필수품챙기기	... 캐리어가 있으시다면 캐리어를 가져가셔도 좋구 백팩을 가져가셔도 좋아여 수학여행기간이 조금 길다면 캐리어가 좋을 듯 해요 무거운 가방을 가지고 다니기 힘드실 때는 크로스 백도 가져가시는 게 좋아요 아침에 일어나서 앞머리와... 
수학여행질문이요^^	... 수학여행 옷코디와 장기자랑 옷코디좀 해주세요!!(사진첨부면 좋아요) 3. 수학여행 갈때 필요한 물건들은 뭐죠? 4. 수학여행가서 심심풀이로 할 놀이 5. 핸드폰 가지고 가두 되나요? *내공 10이용!! 되도록이면 빨리요!!  1. 수학여행... 
5호선 굽은다리역 좋은 수학학원 추천 부탁드려요	... 안녕하세요~ 저는1:1과외 교사인데요 보통 아이들은 수학을 좋아하지 않고 어려워하기때문에 흥미를 가지기힘들어하는 부분이 많이 잇습니다 그런 아이들에게 흥미를 주고 학습습관을 길러주시기엔 학원 보단 1:1과외를 추천... 
중3 수학 기초지식	중3인데 진짜 중1 중2 이때부터 수학을 제대로 안하다가 다시 제대로 수학을 시작해보려하는데 완전 백지상태라 진짜... 인강 + 학원 or 인강 + 개인과외병행하는게좋아요. 실력을 올리는데 효과적인 순서는 1:1 개인과외 > 학원 > 인강... 
영어와 수학을 좋아하라?	"... 선생님께서 ""너가 영어와 수학이 좋아서 성적이 올라야지 대학때문에 영어와 수학성적을 받아 왔기 때문에 너가 지금 좌절하고 있다""라고 말을하셨습니다. 하지만 자꾸 영어와 수학이 좋아하는 이유를 생각하면 할수록 비참해지고 막... "
고1 수학 문제집 추천	... 부분같이 문제 난이도가 어렵게 나와서 못풀수도 있을거 같아요 과외같은 1대1로 학습할때에는 뭐가 좋아요?  개념쎈도 괜찮아요. 전 수학의정석을 많이 사용하지만 중간정도의 아이들은 개념쎈이 가르치기가 더 좋았던 것 같아요.
수학이 잘 않되요ㅠㅠ	제가 수학을 별로 않좋아 하지만 수학이랑과학쪽으로 나가고 싶거든요...ㅠㅠ 그래서 수학을 어쨌든 피할래야 피할수가 없어서 부딪혀 보려구요...그런데..제가 독학을 해서 질문을 할 분도 없고 학교선생님은 바쁘셔서 제가 만족할만한... 
고1수학 잘하는 법	... 방정식하고 부등식은 고2때 문과를가든 이과를 가든 수학공부를 한다면 아주 기본사항이기 때문에 마스터하시는게 아주 좋아요^^ 수학은 인내의학문이라구 ...저 과외선생님이 그러시더군요 ㅋㅋㅋ 이해가안되고 따른과목에비해... 
고등수학문제집추천(내공있음)	"... 심화문제있는 문제집 자이스토리 고등수학 숨마쿠라우데 고등수학 개념원리 고등수학 문제집 좋아요. 문제 수는 적어도 한 유형에 대해 아주 자세히 설명해주고, 다르게 푸는 방법도 설명해 주니까 개념을 다질 수 있는 문제집입니다. "
수학만 못해도 괜찮나요	안녕하세요 위 제목 처럼 수학 빼고 거의 다 잘하는데 수학만이 성적이 안좋아 걱정입니다..꿈이 모션 그래픽 디자이너인데 수학이 그렇게 까진 상관을 미친다고 생각도 안하고요 하지만 수학빼고 성적이 좋은편이니 나중에 대학갈때... 
수학여행어디로 가는게 좋아요?	... 비용도 적게들고 기억에 남는 수학여행이되도록 좋은 곳좀 추천해 주세요.... 좀 멀리는 설악산이 좋을듯 하군요. 그래도 도로가 좋아 금방 갈껄요?산도 있고 앞엔 바다구요...대포 앞바다 일출은 장관입니다.내려오다 보면 양양.강릉... 
수학 물리 좋아하는사람 직업추천	"1.미니어쳐만드는것 좋아함 2.나를 꾸미는 것 좋아함(화장,옷입는 것) 3.공부는 사회말고 과학이좋아요...암기과목 싫어하고 수학, 물리 좋아합니다. 4.발표하는 것 싫어함. 무슨 직업이 좋을까여? 일단 1,2번은 학과선택에 있어서는 거의... "
수학못하는데 이과 가도 될까요..?	"... 수학 과학 보단 국어,영어,사회 점수가 잘나오거든요 그리고 과학보단 사회가 좋고 수학보단 국어가 좋아요 근대 꿈은 이과계열 이에요 그리고 나는 문과보다 이과에 가고싶어요.. 왜냐하면..문과는솔직히 분위기 별로인것같아서요..... "
사직동 근처 수학학원 추천	쌍용 살고있는데 수학학원 추천해주세요 가까운곳으로요 되도록이면 기초를 탄탄하게 해주는 학원이 좋아효 과외나 대형강의? 말구요 학생의 스타일과 현재 상태를 명확히 알고 선택을 하셔야 해요. 실력을 올리는데 효과적인... 
수학교사 되는법	"고1 학생인데요 수학을 좋아하고 중학교 수학성적이 잘 나와서, 가르쳐주는걸 좋아해서 수학교사를 희망하는데요 고1 수학이 너무 어려워요ㅠㅜ 수학시간마다 이해가 안 가서 진짜 눈물을 몇번 삼켰어요 중학교때랑은 완전 다른거... "
5학년 수학여행 질문이염 ^ㅡ^	"... 2.수학여행은..첫째날은 적당히 티셔츠, 스키니진 또는 청바지가 좋아여^_^ 수학여행때 치마입음 넘 불편할테니.둘째날은 설악산갈듯싶어서 덥지않게, 뒤에 힘들어서 헥헥될때 안보이도록 얇은후드티, 끼지 않는 바지(청바지)... "
일품 수학 공부	... 웬만하면 다 푸는게 좋아요. 수학을 못하신다고 밝히셨으니;;ㅎㅎ 너무 힘드심 안푸셔도 되지만 나중에 더 고생하지 않으려면 지금 단기간이라도 빡세게 하는게 좋습니다. 특히 중등수학은 다른거보다 훨신 중요합니다. 
대치동 수학학원 기 초부터 잘 해주시는 곳	"... 다 좋아요. 국어를 잘 하면 다른 과목도 모두 잘 할거란 생각으로 믿고 맡겼는데 정말 사회, 과학, 영어까지는 사교육에 아 이 공 부 욕심까지 더해져서 어떻게든 성적이 잘 나오는 편인데 수학이 제일 문제더라구요 저도 수학... "
수학인강추천 전준홍 vs ebs 문풀 수학인강 추천	... 전준홍 선생님이랑 ebs 선생님 중에서 수학인강 문풀인강쪽으로 해서 들을건데 수학인강 어디가 좋아요?? 지금 수학 b형 3등급대인데 문풀인강 듣고 1등급으로 올리려구요.. 전준홍 선생님은 아는 선배가 들었고 ebs 선생님은... 
수학성적 올리는법	"... 과학, 사회, 기술가정, 도덕, 한문 같은 암기 과목으로 평균을 높이고 이후 수학 등에 지속적 투자하는 것이 좋아보입니다. 결론 1. 수학은 응용이 핵심인 과목이므로 단기간에 성적 향상은 쉽지 않음. 2. 기본기가 갖춰줘야 인강이... "
성화여고 근처 수학학원 추천	성화여고 근처에 수학 학원 추천해주세요 1:1로 가르쳐주고 개념부터 차근차근 알려주는데면 좋아요!  안녕하세요^^ 성화여고 학생들을 지도하고 있습니다! 성화여고 내신관리는 국어 영어 수학을 주로 수업을 하고 있는데요~ 학생의... 
인천 중구 신흥동. 미추홀구 용현5동쪽. 고1 수학과외.	... 수학과외 하고 싶은데. 주말에요. 대학생 선생님도 좋아요. 어디서 찾아야 하나요?  안녕하세요 인천 중구 신흥동 미추홀구 고등 수학과외 진행중인 선생님 입니다. 학생에게 필요한 학습을 바탕으로 방향성을 잡아 수학 전문... 
중2수학이요!(작년 중 2중에서... 	"... 작년 대전 삼천중 2학년 수학시험 문제라고 나와있네요;;; 혹시 아시는분있으면, 식이랑 주셔도 좋고 식없이 답만 주셔두 좋아요! 제발 부탁드려요ㅜㅜ 내공 100 걸구요,내공냠냠이나 이런거 말구요ㅜㅜ.................... ------- "
수학여행을 가는 두근두근 초등학생입니다+_+	"... 저는 평범한 옷이 좋아요~~^ ^ 5. 수학여행가서 재밌게 노는 방법좀..헤헤 6. 수학여행을 경주로 가는데요, 가서 어디어디 돌아다녀요..? 또 TV랑 침대도 있나요? 7. 여러가지 준비물좀 써주세요.. [샴푸, 로션, 세면도구, 우의]같은거요... "
수학.영어문제집 추천좀 해주세요..(내공)	"... 그래도 아직까지는 수학이 제일 좋아요.. 저는 지금 생각하는게. 정석하고, 문제가 많은 문제집. 이렇게 살까 생각중인데.. 수학문제집 추천좀 해주시구요.. 그리구 영어는.. 정말.. 못하고 싫어하는과목중 하나에요.. 1학년때... "
중학생 수학학습지 어떤게 제일 좋아요 ?	... 문제집도 수학자습서랑 과학문제집 밖에 없어요 ;;... 수학 !!! @.@ 진짜 모르겠어요 ;; 선생님이 말씀해주시지만... ㅠ 그러구요 부천에서 삽니다 ..수학교과서 출판사가... 저는 수학만 할꺼거든요 ;; 가격좀 알려주시구 -_-; 그리구 저는... 
수학문제집 모가좋아요?	중학교 수학문제집이요  쎈이 좋습니다
중딩 수학 연산책 추천 !!!!!!	... 제가 중1이고요 수학연산책 좀 빨리 추천해주세요 ㅠㅠ 제가 수학학원에서 선생님이 추천해준 연산 책들 인데 1.연산으로 푸는 수학 2쎈연산 이 문제집 두가지가 제일 좋습니당!참고로 이 둘중에서 연산으로 푸는 수학이 더 좋아여 
수학문제지 추천해주세요	"... 5.최상위 수학 (디딤돌) 이것도 좋아요. 근데 제가 생각했을 떈 고난도 수학보다는 조금 쉬운 거 같아요. 쉽다고 해서 그 쉬운게 아니라. 어렵습니다. 6.고난도 수학 (지학사) 이건 정말 고난도 수학입니다. 특목고,민족사관고 기출문제도... "
중1 수학 유리수 계산 내공 90 빨리 알려주실 수록 좋아요	정수와 유리수 단원이에요 ㅠㅠ 풀이~~~ 
고1수학문제집 추천	"... 1.기초개념으로는 교과서와 정석으로 할건데요...중간단계 문제집으로 무엇을 할지 모르겠어요 좀 추천해주세요(쎈은 가급적 피하고 싶어요) 2.고난도문제집으로는 일품,1등급 만들기, 초강수 중에서 뭐가 좋아요??? 수학의 신님들 제발... "
초6 추천하는 수학 문제집..	... 국어는 아무거나 사도 되구요 ㅋㅋㅋ (교과서가 전부예요 ^^!) 수학은 개념원래 좋아요요!! 그러나 ~ 수학은 문제집 여러개 풀어봐야 잘 할수 있는거 같아요 ㅎㅎ 그래서 저는 개념원리 노란색 풀다가 다 푼다음 분홍색 풀구요 ~ 이것도... 
수학공부법	... 라고 고민할수 있어 좋아요 수학의생명은 풀고 또풀고 다시풀고 문제를 내것으로 만드는 것인것 같아요 제가 추천하는 이 문제집 해법수학이라는 책 한번 써보시는 것 좋을것 같아요 그외 책을 추천 드리자면 국어 - 한끝 사회... 
수학의 잘아시는여러분들께..	"... 공부를 좋아 할수 잇게 또 수학을. 좋아 할수 잇게 도움이 되는 답변좀 해주세요 부탁 드려요! ㅜ_ㅜ;;  혹시 현재 글쓴님은 몇학년이신지요.^-^.. 전 현재 고등학생2학년입니다. 많이먹은건 아니지만,저도 수학으로 울고 불고 하고... "
초등수학문제집 추천!	"... 개념과 문제 풀이 영상까지 학습할 수 있고, 세트로 구매 시 1~2학년 연산문제집, 3~6학년은 단원평가 문제집을 별도로 제공하니 전과목으로 개념을 잡기에도 좋아요! 초등수학문제집추천 해드렸는데 고민에 해결 되셨으면 좋겠네요~ "
15살만 답 해주세요 님들은 수학이랑	15살만 답 해주세요 님들은 수학이랑 영어 중에 뭐가 더 좋아요? 둘 다 싫어요 금지 개인적으로 저는 영어를 더 좋아합니다 수학도 좋지만 시험치는 과목으로서는 저는 영어가 훨씬 좋아요 
고2 이과생인데 수학성적이 너무 안좋아요	"고3 수험생을 둔 학무보입니다 아이가 이과생인데 수학등급이 내신은 5등급... 이과생이라면 모의고사 수학B에서 적어도 1, 2등급은 맞춰야 합니다. 즉, 내신... 수학B에서 좋은 등급을 확보할 것 2. 논술 공부를 할 것 3. 논술에서 요구하는... "
수포자 수학 공부 하기 싫습니다	... 공부 자체는 하기 싫지 않아요 수학 공부만 하기 싫어요 다른거 다 좋아요 과학 영어 국어 다 좋아요 수학만 이 시1발놈 아주 싫어요 어떤 방법이 없을까요? 시험 전부터 수학 공부만 해서 스트레스 받아가지고 노이로제 올거 같은데... 
국어 수학과외고 빠른시일내에 시작 할수있으면 좋아요.	"국어하고 수학과외를 방문해서 가르치시는 선생님을 구하는데... 대상으로 수학, 영어, 국어를 전문으로 하고있는 1:1 과외 전문 재재쌤입니다! 현재 자녀분의 국어 수학 수업을 찾고 계시네요! 수학 국어는 주요 과목이기 때문에... "
수학선생님이되고싶습니다.	"... 수학을 좋아하신다면 수학을 잘 하시게 될 겁니다. 좋아하시는 만큼, 아니 그 보다 더 이상을 공부하시면 충분히 좋은 결과 얻으실 것이라 보입니다. 물론 공부하는 방법이 잡혀있어야 합니다.. 이에 대해서는 어떻게 말씀드릴 수가... "
고등학교 수학!	... 수학을못하기는하지만(이번 중간고사 점수는 어떻게 나올지..) !!!진짜 수학을 좋아해요. 그러니까 수학을 못하는데 수학이 너무좋아요 지나치게좋아요 국어공부하다가도 수학문제 풀고싶고 사회공부하다가도 수학문제풀고싶고... 
수학vs종합학원	... 아 그리고 수학학원만 다니는게 좋아여 아니면 종합학원만 다니는게 좋나여? 그리고 밀가루라는 사이트 거기 좋나여? 해보신분만 그럼 답변 달아주세요 학원 특성상 진도를 위주로 수업이 진행이 되는 경우가 많습니다 그렇기에... 
중2 1학기 수학 무료 문제	학원에서 2학년반 들어가기 전에 예습하려고 집에서 인강을 들으려고 하는데 무료 수학 문제를 다운로드 할수있는 곳 아시는 분ㅠㅠ인강 추천도 좋아요..! 김수's 수학마루 라는 곳에서 회원 가입만 하면 초중고 수학 프린트 문제를... 
백점맞는수학	제가4학년인데 백점맞는 수학을 사면 좋나요?  아직 초 4 라면 ... 백점맞는 수학도 좋아요 아님 쎈수학도 좋아요 일다 문제가 많지요 ㅎㅎㅎ 일단 초딩이면 계산실수만 안하시면됨
중3 수학문제집 질문^!^ ★채택과 좋아요 1번★	... <답변해주시면 채택과 좋아요 1번 눌러드립니다ㅏ~~^^>  서점에 가시면 일루와라는 수학교재를 사셔서 일루와 사이트 회원 가입후 시리얼 번호 입력하면 무료로 동영상 강의를 들으실수 있습니다 열공 하시어 부디 좋은 성적... 
"수학여행에 대해서,,,,,,,,"	... 제가 서울로 수학여행을 가는 데요...서울로 가면 좋아요??? 4. 수학여행에 가면 장기자랑이 있어요??? 5. 교관 있어요???? 6. 휴식 시간이 많아요????? 7. 취침 시간은 언제고 기상 시간은 언제예요????? 좀 많죠......죄송해요.....그래두... 
분석수학에 대하여	"... 전 수학이 좋은데,, 제일 좋아요^^ 수학은 계속 풀고 지겨워도 하고,,계속하다보면 금방 재미있어질거에요,, (제가 다니는 수학학원:분석수학<아주좋아요>) ●집중 잘하는 방법 목표를 위해 달성할려면 꾹 참으세요.. 놀고 싶어도..... "
고1 수학 기본서좀 추천해주세요	"... 수학의 정석을 쓰고 있는데, 다른 애들 책보니까 정석보다 더 좋아보이더라고요,, 수학(하)부터는 새로운 기본서를 쓸라고 하는데 추천좀해주세요 명문고고요. 수학문제 어렵게 나와요. 개념원리, 개념+유형, 정석, 바이블, 등등... "
"남현동 수학 , 영어 학원"	"남현동 수학학원 영어학원 추천좀 부탁드려요 .? 지금 다니고 있는 학원이 도움이 되긴 하겠지만 크게 본 효과가 딱히 없어서 찾고 있습니당. .? 1:1 일 수록 좋아요 학원은 기본적으로 그룹수업이지, 1:1 수업은 아닙니다. 학원 다닐... "
초등수학문제집 챙겨볼려고요	"... 개념과 문제 풀이 영상까지 학습할 수 있고, 세트로 구매 시 1~2학년 연산문제집, 3~6학년은 단원평가 문제집을 별도로 제공하니 전과목으로 개념을 잡기에도 좋아요! 초등수학문제집추천 해드렸는데 고민에 해결 되셨으면 좋겠네요~ "
중등2학년 수학문제집 추천	"전 중2인데요 수학문제집을 더 구입하고 싶은데,, 제가 지금 쎈, 최고득점수학, 개념원리를 가지고있는데 문제 매우많고 난이도가 좀있는 수학문제집없을까요?? 추천해주세요 급해요!  유형아작 쎈 수학 완자 수학 이 좋아요."
4살아이 수학전집추천	... 세이펜으로도 활용할 수 있어서 아이스스로도 잘 활용할 수 있어서 좋아요. 수학에 흥미없는아이도 책을 싫어하는 아이도 인기 캐릭터 대발이와 함께하니 즐겁게 활용할 수 있더라구요. 
"수학의정석 ,개념원리 둘중 어떤게 좋아요?"	저는 중3인 학생인데 10-가를 혼자 독학하려고 하는데 개념원리 수학의 정석중에 어떤게 더 좋아요? 9-나는 다 끝내서 하려고 하는데 어떤게 더 좋아요?  당빠 수학의정석이훠배낫습니다
수학 동아리 면접 질문	고등학교 수학동아리 면접 완전 빡셀것 같은데 아마 고1 수준에서 개념 정의 문제 같은거 나올것 같은데 뭐 나올건지 예상 좀 사주세요ㅠㅠ 많이 예상해주시면 너무너무 좋아요  안녕하세요. 진정성있게 답변하는 친절한지식인... 
고1수학....	... 근본적으로 수학을 정복하려면 첨부터 다시시작하는게 좋아보입니다. 수학책 쭉~ 읽어보시면 뭔말인지 거의 다 아시겠습니까? 사실 이게 되면 수학 혼자해도 됩니다. 이건 1등급이나 2등급중에서도 1등급에 가까운 상위2등급... 
"수학여행에 대해서,,,,,,,,"	... 제가 서울로 수학여행을 가는 데요...서울로 가면 좋아요??? 4. 수학여행에 가면 장기자랑이 있어요??? 5. 교관 있어요???? 6. 휴식 시간이 많아요????? 7. 취침 시간은 언제고 기상 시간은 언제예요????? 좀 많죠......죄송해요.....그래두... 
제가 수학교육과를 가고싶은데요...	제가 중학교때부터 수학을 좋아했는데요 지금 내신이 좀 많이 안좋아요... 수학교육과는 수능성적으로만 갈 수 없나요?? 지금 고2인데요 고3때 내신이 많이 들어가나요?? 지금 2학년 2학기 기말과 3학년때 시험 4개가 남았는데요 이 5개... 
중 1 수학문제 정답만주셔도 좋아요	제목 그대로입니다 총4문제 부탁드립니다 56번 문제 처음에 x개를 샀다고 합시다. 그러면 남은 사과는 (x-50)개 이죠. 그리고 30%를 붙여 팔았으니 61번 문제 62번 문제 열차의 길이를 x m라고 하고 속력의 초속 y m라고 하고 식을... 
6학년 수학	"... Q2. 수학문제집은 6학년 수학을 더 이해가 잘되게 하는 문제집을 추천해 주세요. 해법수학이나, 큐브수학 같은 게 좋아요^^ 문제도 많고 다양한 유형으로 공부하게끔 해놨어요~~ 채택부탁드립니다 "
중1수학문제집 기초 부족	"... 개념편으로 개념 정리를 하면서 처음에는 쉬운 문제 위주로 풀어보며 개념을 익히고, 유형편에 있는 다양한 문제들을 풀면서 심화 문제에 대한 연습을 하면 좋아요~ 수학을 혼자 공부하는 부분이 힘들다면 수박씨닷컴을 추천합니다... "
수학공부 잘하는 방법! <내공 50★>	... 수학 경시대회 같은건 진짜 점수 안좋아요... 수학 잘하는 방법 좀 갈켜 주세요. 다른 과목도 다 갈켜 주심 감사하겠씁님다. 진짜 귀찮으시겠지만 해야 합니다 ^^* 우선 늘 말 하듯이 ㅋㅋ 수업시간에 선생님 말씀 잘 들어야 하구요.... 
디딤돌 수학 개념원리~	"... 공통수학개념원리 이게 좋아여? 전 수학 한번도 해본적없는넘일정도? ㅋㅡ.ㅡ 먼저 개념원리는 디딤돌에서 만든것 맞습니다. 그리고.... 공통수학 개념원리는 과거 6차교육과정때의 공통수학 문제집입니다.. 그리고 수학 10-가, 나... "
수학..영어..문제집 추천좀	"... 그래도 아직까지는 수학이 제일 좋아요.. 저는 지금 생각하는게. 정석하고, 문제가 많은 문제집. 이렇게 살까 생각중인데.. 수학문제집 추천좀 해주시구요.. 그리구 영어는.. 정말.. 못하고 싫어하는과목중 하나에요.. 1학년때... "
고1 수학	... 수학은 전단계가 완벽하게 되지 않으면 단계가 올라갈수록 구멍이 뚫린다는 것을 기억하세요! 도움이 되셨다면 채택과 좋아요 꼭 부탁드립니다 ㅎㅎ 다른 질문 있으시면 채택해주시고 댓글이나 1대1로 또 물어봐주세요 최대한 빨리... 
수학을 수능 최저로 맞추기 어렵나요?	... 미적분 칠 생각이에요 우연히 담임선생님과 이 얘기를 했는데 수학으로 하기 힘들다고 표정이 안좋아지시더라고요.. 수학학원 다니는 것도 별로 안 좋아 하시고요... 국어를 치기엔 제가 등급이 너무 낮아요 못하기도 하고 적절한... 
초등수학문제집 기초잡기	"... 마지막으로 QR코드를 통해서 개념과 문제 풀이 영상까지 학습할 수 있고, 세트로 구매 시 1~2학년 연산문제집, 3~6학년은 단원평가 문제집을 별도로 제공하니 전과목으로 개념을 잡기에도 좋아요! 초등수학문제집추천해드렸는데... "
수학선생님!!	... 공무원도 안정적 이고 편한데...(모르는 사람들생각.) 교사는 정말로 아이들을 위하고 사랑하는 맘이 없으면 안됩니다...특히 수학교사는 수학을 좋아하고 아이들에게 수학을가르치는 보람으로 하는 거지 외적인 조건으로 하는것은... 
수학쌤이 너무 좋아요 ㅠㅠㅜㅠㅠㅠ	제가 학원을 다니는데요 학원 수학쌤리 너무 좋아요 ㅠㅠㅠ 제 원래 이상형이 좀 아저씨 같은 섹시한 사람이라서 그런건지 뭔지.. 근데 현실적으로 나이차도 그렇고 이루어질 수 없는 걸 알아서 그건 기대도 안 하고 있고요 기억에라도... 
수학과vs수학교육과	수학을 좋아하는 학생입니다. 그런데 수학과랑 수학교육과 중 선택을 못 하겠어서요. 솔직히 가르치는 것은 그닥 좋아하지는 않아요. 그냥 초등학교 들어가기 전 부터 수학만 좋아했고 수학이 거의 제 인생이어서요 ㅋㅋㅋ 그런데... 
수학여행가면 콘도로 가는데..좋아요??	... 5학년때 수련회를 갔지만 수련회랑 수학여행의 분위기는 사뭇 다르데요...... 수학여행이니까 콘도방이 그것보다 조금은 안좋겠죠..^^ 경주일성콘도... 수학여행이라는게 중요하죠...ㅋㅋ 수학여행 첫날밤에는 그냥 애들끼리 놀게... 
중학교 과정 수학 문제집 추천해주세요	"고3인데 수포자라서 조금씩 공부해보려 합니다 중학교 과정 수학 문제집 추천해주세요 ,,, 기출비에 있으면 더 좋아요 부탁드려요 ㅜㅜ  중학생용 과정 수학 문제집 중에서 추천해드리면, ""수학의 바이블"" 시리즈나 ""하늘을 달리다... "
예비고1 수학 독학	수학 독학 하려는데 이해 잘되게 설명해주시는 강의 추천 부탁드려요 문제집도요 강의랑 문제집 같은 거면 더 좋아요 수상 수하 다 추천부탁드려요  강의랑 문제집이 같은건 인강 강사들은 대부분 본인이 만든 교재를 쓰니까... 
"고등 수학, 사회 문제집 뭐가 좋아요?"	"고등 수학, 사회 문제집 뭐가 좋아요? 알려주세요 ^^  안녕하세요^^ 사회문제집 때문에 답답해 하시는것같아서 알려드려요 이곳이 바로 그 유명한 검색서비스 NO.1 정보사이트입니다 사회문제집 찾는 많은 분들이 이곳만 이용하는 이유가... "
수학 정말 못하는데 간호학과	... 다른 과목은 다 성적이 좋아요. 수학 성적 정도가 어느정도냐면 중학교 수학도 어려워 20점~30점 대에 머물렀습니다. 어제 모의고사 본 건 겁이나서 차마 채점도 못하겠어요. 간호사 꼭 되고싶습니다. 지금부터라도 안일한 마음... 
고2 문과 수학 진짜 고민이요...	... 1.중학교 내용들 고1수학등 하시면 좋아요 근데 이건 67등급애들이 하는거에요 ㄹㅇ 45등급이면 시간낭비입니다. 2.그냥 학원을 옮기세요 대학생 1ㄷ1이라해도 이상한 놈들 많아요 3.다시한번 말하지만 시간낭비입니다. 4. 차라리 지금... 
수학 노베이스	"수학이 노베이스라 ebs에서 정승제 50일수학 다 듣고 메가스터디에 현우진 시발점으로 넘어왔는데 시발점 수학 상,하... 인강 + 학원 or 인강 + 개인과외병행하는게좋아요. 실력을 올리는데 효과적인 순서는 1:1 개인과외 > 학원 > 인강... "
수학학원 활용하기	"... 가장 중요한 것은 선생님께 물어보고, 그 내용을 반복해서 학습하는것이에요^^ 하지만 학원에서는 질문답이 어려운 경우들이 많아서 수학같은 경우는 일대일수업받는게 훨씬 효과가 좋아요! 저는 수학전문으로 일대일 수업하고있는... "
중학교교사(수학)됄 수 있는 방법	"... 요즘 수학 점수가 안 좋아요. 저번에 최악 88점이 수학에서 평균10점 날려먹고... 그런데 제가 수학이너무좋은데,국어점수가 요즘은 잘 나오더라구요... 그래서 '국어로 갈까?'라는 생각도 하고... 그래서 국어,수학교사를 하는 방법과... "
중 1 수학문제 정답만주셔도 좋아요	제목 그대로입니다 총4문제 부탁드립니다 56번 문제 처음에 x개를 샀다고 합시다. 그러면 남은 사과는 (x-50)개 이죠. 그리고 30%를 붙여 팔았으니 61번 문제 62번 문제 열차의 길이를 x m라고 하고 속력의 초속 y m라고 하고 식을... 
중등수학...	"... 정말장난이아니더군요............ㅋㅋㅋ 그런데 에이급수학정말좋긴좋아요 C단계(제일쉬움), B단계(중간), A단계(심화) 이렇게나뉘는데. B단계로많이하시는게좋구요 가끔가다 A단계도 확인해주시고요 . 개인적으로 에이급수학강추합니다... "
수학 상 문제집 추천해주세요	... 제가 도움이 될 수 있을 것 같아서 글을 남기게 됐어요!!^^ 물론 수학의 왕도 책도 좋아요!! 그런데 생각하시는 것처럼 수학은 유형을 잘 정리하고 모든 유형을 얼마나 빠르게 잘풀수 있나가 핵심이에요!! 그런 뒤에 유형이 탄탄해야... 
수학여행가면 콘도로 가는데..좋아요??	... 5학년때 수련회를 갔지만 수련회랑 수학여행의 분위기는 사뭇 다르데요...... 수학여행이니까 콘도방이 그것보다 조금은 안좋겠죠..^^ 경주일성콘도... 수학여행이라는게 중요하죠...ㅋㅋ 수학여행 첫날밤에는 그냥 애들끼리 놀게... 
수학이 수학이 lllllllllllllll	"... 하아,,, 기말고사가 한달도 안남았는데 어쩌면 좋아요 ㅠ 저 전번에 수학때문에 평균이 와장창(6점이나 떨어졌음) 떨어져서 ㅠ 좋은 조언 좀 해주세요 저 동대문구 이문동에 사는데 가까운 좋은학원 있으면 추천좀 해주세요 ㅠㅠ http... "
수학 정석 구성?	"... 악플 반사 #1 : 수학 교재 바이블이 좋아요, 수능 방송 보세요, 어디 학원 좋아죠 이렇게 딴소리 할 학생들은 콧물 닦고 가갸거겨부터 다시 익히시고... 악플 반사 #2 : 할일이 없어서 수학공부나 하냐고 하실 분들은 계속 그렇게... "
수학을 과외로만 돌리다가 다닐만한 판	"... 대치동에 학원이 워낙 많다보니 다 좋아보이네요~~~ 사실 대형학원 가면 평타 이상은 칠거같은데 너무 또 대형에서 여럿이 공부하는것보다 적당하면 좋을거같아요 추천해줄 만한 학원 없을까요 ??  네, 수학 공부에 관심이 많은 중1... "
수학 여러 가지 문제	수학문제 같은 거는 그냥 개념도 이해하면서 여러 가지 문제 응용 문제 같은 거도 익히는 게 좋아요?? 당연합니다. 일단 개념 이해를 확실하게 하셔야 하구요~ 수학 교과서를 이용하는 것도 좋습니다. 개념이 잘 정리되었으면 그것을... 
수학여행에 대하여(포시즌 유스호스텔)	... 돈은 어느정도 가져오는게 좋아요? 5. 수학여행에 휴대폰 못가져오게 해요? 6. 밤은 언제쯤에 새는게 좋은가요? 7. 수학여행의 필수품은 무엇인가요? 8. 교관들은 어디에서 자나요? 9. 학생들은 어디에서 자나요? 10. 성실하고 신뢰성... 
진짜 진지하게 수학공부 질문 합니다..	"... 전 공부가 진짜 좋아요. 수학이 너무 재밌고, 국어를 할 땐 선생님이 된 것 같고, 영어를 할 땐 항상 자신감이 넘치고, 과학을 할 땐 천재가 된 것 같고, 역사를 외울 때 너무 즐겁고, 사회를 할 땐 세상을 알아가는 것 같아 너무 좋아요.... "
중 · 고등 학교 수학선생님이 되는 방법. ?	"... 공부를 좋아 하진 않지만 수학은 나름 좀 좋아합니다. 그래서 학교 수학선생님을 하고싶은데요, ( 초등학교는 아닙니다.) 묻고 싶은것은 이것입니다. 1. 대학 4년제 사범대를 가기 위해서는 어떻게 해야되나요. +( 지금부터 얼마나... "
수학쌤이 너무 좋아요 ㅠㅠㅜㅠㅠㅠ	제가 학원을 다니는데요 학원 수학쌤리 너무 좋아요 ㅠㅠㅠ 제 원래 이상형이 좀 아저씨 같은 섹시한 사람이라서 그런건지 뭔지.. 근데 현실적으로 나이차도 그렇고 이루어질 수 없는 걸 알아서 그건 기대도 안 하고 있고요 기억에라도... 
6세수학 궁금해요~	... 조언 좀 해주세요 ㅠㅠ 걱정이 태산입니다  안녕하세요 아이가 걱정되는 마음에 질문 남겨 주신 것 같아요 6세 친구들은 수학과 친하게 지내면서 재미있게 공부하는 환경이 중요하고 수에 대해 개념을 천천히 배우는 것이 좋아요... 
수학학원 과 영어학원 다녀보려고해요 공부방 좋아요	... 영어학원 수학학원 국어학원 관심이 있으셔서 답변... 많이 고민도 되실텐데 이왕 영어학원 수학학원 하시는 것... 시흥장곡동초등학생영어학원 장곡동초등학생수학학원... 장곡동중학생수학학원 장곡동단과학원... 
"고등 수학, 사회 문제집 뭐가 좋아요?"	"고등 수학, 사회 문제집 뭐가 좋아요? 알려주세요 ^^  안녕하세요^^ 사회문제집 때문에 답답해 하시는것같아서 알려드려요 이곳이 바로 그 유명한 검색서비스 NO.1 정보사이트입니다 사회문제집 찾는 많은 분들이 이곳만 이용하는 이유가... "
중1 수학 문제집 추천	... 개념서지만 문제도 몇개씩 들어있어서 좋아요!! 수학은 개념잡고 문제위주로 풀면 되는것같아요. 저는 학원을 안다니는데 이 책 설명이 엄청 자세히나와있어서 이해하기 좋았어요 문제위주로 돼있는건 아무래도 제일 유명한 <쎈... 
중3 고등수학 선행질문	"... 여러권도 좋아요!) 2. 지금부터 열심히 하면 저 친구들 따라 잡을수 있을까요? 3. 인강을 듣는게 좋을까요?  수학 개념서로는 개념원리, 바이블, 개념쎈 많이 사용합니다. 그리고 문제 풀이 용으로는 알피엠이랑 라이트쎈, 쎈... "
중2 수학문제집/공부법 추천	... 시험기간에 풀기좋은 문제집은 이 셋중에서 어떤것일까요? 제가 공부하는게 역사같은 영수 제외과목은 그냥 닥치고 외우는데 수학은 어케 공부해야하나요ㅜㅜ  쎈이요!! 문제 유형 엄청 많아서 좋아용 전 쎈 풀고 수학 100점 맞았어요
고2 수학공부..어떻게해야하죠!	"... 진짜 초딩떄이후로 수학성적이 좋아봤던적이없어요!...악!!! 고1 겨울방학때 고2때는 정말 수학을 잘해봐야지!하면서 기초가없나싶어서 중3때껄 다시했어요,.. 고1때꺼도다시할려고했는데!!!!!!!!!!!!!!!!!!!!!!!!고2가돼버려서!!!!!!!!!!!!!!!...... "
국어 수학과외고 빠른시일내에 시작 할수있으면 좋아요.	국어하고 수학과외를 방문해서 가르치시는 선생님을 구하는데 우리 아이가 산만하고 진중을 오래해지못해 차라리... 산만하고 집중을 잘 하지 못하는 학생을 확실하게 잡아주실 수 있는 교사와 국어와 수학과목 과외를 필요로 하고... 
(중1)수학선생님 말투가 짜증나요!!!!!!!!!!!!	... 하..그래서 전 금요일이 젤 좋아요(수학이 안들어서요.) 수학 잘하는 방법 좀요!  수학잘하는 방법은 일단 쌤이랑 어느정도 친해져야하는데..ㄷ 이런상황이니.. 그럼 독학방법밖에없네염.. 학원다니시면 그때그때 배우는거 복습하시고... 
예비고1 수학 정승제	"... 50일수학을 다 듣기보다는 빨리 고1 과정을 시작해서 (물론 50일 수학에 고1과정이 일부포함되어 있지만) 최소한 이차함수의 최대, 최소라는 단원까지는 진도를 나가시는 걸 추천드립니다. 어떤 걸 해도 좋아요. 어떤 강의를 듣던... "
경주 수학여행가는데요 .	... 경주삼성유스텔좋아요 ? 3. 수학여행때 입고갈옷 코디좀요 얼굴은좀 큰편에 키는 161cm 몸무게는 58kg인데 뭐입으면 좋을지좀 .. 4. 무슨노래 부르면 분위기 띄울까요 ? 5. 뭔 놀이 해야 재밌어요 ? [수학여행밤에] 6뭔 놀이 해야... 
[예비고1] 수학의정석//개념원리 어떤게 더 좋아요?	수학의 정석과 개념원리중에서 어떤게 더 좋은가요? 제가 EBS강의를 듣고있는데요 - EBS 강의를 다 듣고난뒤에... 단원맨처음장에 요약별로 집약되있고 문제도 쉬운걸로 구성되어 있어서 수학을 맨처음 하실때는 괜찮은 교재라... 
수학 상 문제집 추천해주세요	예비고1입니다 수학 상 혼자 공부하려고 하는데 너무 어려운 것보다는 혼자 공부하기 좋은 개념도 잘 나와있는 문제집 좀 추천해주세요 (광고하지 말아주세요 직접 써보신 거 추천해주시면 더 좋아요!)  수학 개념서로는 개념원리... 
수학여행질문이요^^	... 수학여행 옷코디와 장기자랑 옷코디좀 해주세요!!(사진첨부면 좋아요) 3. 수학여행 갈때 필요한 물건들은 뭐죠? 4. 수학여행가서 심심풀이로 할 놀이 5. 핸드폰 가지고 가두 되나요? *내공 10이용!! 되도록이면 빨리요!!  1. 수학여행... 
고등학교 1학년 수학...	... 수학 빼고 나머지 과목들은 진짜 ㄱㅊ은데 수학이 제 발목을 잡네요....... 제가 중학교 1학년때는 수학을 좀... 인강 + 학원 or 인강 + 개인과외병행하는게좋아요. 실력을 올리는데 효과적인 순서는 1:1 개인과외 > 학원 > 인강 독학이... 
"수련회는 몇학년이구, 수학여행은 몇학년이죠?"	"... 수련회가 좋아요... 수학여행이 좋아요? 5,6학년 언니 ,오빠들은 빨리빨리 답변이용~ 제대로 안 하면 신고 합니다!!! 안뇽~~~ㅋㅋㅋ 내가 알려주겠어...ㅋㅋ 1. 수학여행은 거의 다 6학년이고 그런데... 학교마다 달라...ㅋㅋ 2. 수련회때... "
수학여행질문이요^^	... 수학여행 옷코디와 장기자랑 옷코디좀 해주세요!!(사진첨부면 좋아요) 3. 수학여행 갈때 필요한 물건들은 뭐죠? 4. 수학여행가서 심심풀이로 할 놀이 5. 핸드폰 가지고 가두 되나요? *내공 10이용!! 되도록이면 빨리요!!  안뇽하세요.... 
수학에 대해서여~봐주세여~`	... 그런데 제가 생각하기에는 별로 않좋아여 항상 수학 성적이 낮아여.. 그래서 저 혼자서 공부하거나 과외 학원 중에서 하나 하려구요.. 저 혼자 공부 하면 엄마가 절 못믿는것 같아서여.. 학원은 일주일에 3번정도 가는데 10만원이고..... 
수학 공부방법	"... 모르면 답지를 보는 것도 좋아요. 수학문제를 풀면서 가장 안좋게 공부하는 사람이 개념만 배우고, 모든 수학 문제는 응용이므로 답지 안보고 자기 힘으로 푸려고만 하는 사람들이 있어요. 수학도 어느정도는 암기가 필요해요.... "
수학과외선생님 추천해주세요 아니면 상인동도 좋아요	... 아니면 근처에 상인동과외도 좋아요 예비고등학생이라서 선행학습을 하고싶어요. 잘 가르치시는 선생님 있으면... 상인동과외 대천동과외 초1 초2 초3 초4 초5 초6 중1 중2 중3 고1 고1 고3 상인동영어과외 상인동수학과외 대천동영어과외... 
수학교육과 생각하고있는	... 저는 공부 중에서는 수학을 가장 좋아해서 중학교 수학 교사가 어떨까 생각하고있어요 근데 수학교육과 가면 어려운 거 엄청 많이 배울 거잖아요..... 제가 사실 머리가 문과쪽에 가까운데 수학은 엄청 노력해서 잘 하게 된거거든요... 
중2올박수학 프리미엄답지21쪽부터25쪽까지답지좀요... 	중2올박수학 프리미엄답지21쪽부터25쪽까지답지좀요~~^^사진이면 좋아요 확인 후 채택 부탁드립니다. 
미적분1 수학기출문제집추천	... 암튼 그렇게 많은건 아니에요 그냥 딱 미적분1 연습용?으로 적당한 양이라 좋았어요 그리고 인기북스 기출문제집들은 전부 스프링이에요 그래서 풀기편해서 완전 좋아요.. 개정수학 반영한 미적분1 수학기출문제집이라서 필요없는... 
대치동 수학학원 과외? 판서?	"... 것도 좋아요! 대치동 수학학원 방식이 어떤지, 교육진행은 어떤지, 대치동 수학학원 소수정예인지.. 강사분들 실력은 어떻고, 아이들 어떻게 가르치는지 등등!! 그렇게 꼼꼼하게 대치동 수학학원 알아보다 보니까 대치동 수학학원 정말... "
6세수학 궁금해요~	"... 놀면서 배우는 것도 중요하지만, 집중할 수 있는 환경과 태도도 중요합니다~ 유아의 수학의 시작은 도형의 인지부터 차근 차근 해주시는게 좋아요~ 입체도형이 아니라 동그라미, 세모, 네모 정도는 인지할 수 있어야 하는데요!... "
중등수학문제집 어떤 게 좋아요?	중등수학문제집 어떤 게 좋아요? 수학 개념쪽 같은 경우에는 이해가 되었는데 유형 부분이 아직 이해가 잘 안돼서 수학 유형 쪽으로 공부를 더 해야 될 것 같은데 어떤 중등수학문제집으로 풀어야 할지 감이 안 오네요 유형 쪽으로... 
수학과 수학교육과 대학교 관련 질문	수학과나 수학교육과가 있는 이름 좀 있는 학교들 정리해서 알려주세요!! 지방대도 같이 주시면 좋아요. 링크나 학교들 나열해서 알려주세요!!! 내공 150  안녕하세요. 대입정보포털이라고 어떤 학과가 어느 학교에... 
중학교 과정 수학 문제집 추천해주세요	"고3인데 수포자라서 조금씩 공부해보려 합니다 중학교 과정 수학 문제집 추천해주세요 ,,, 기출비에 있으면 더 좋아요 부탁드려요 ㅜㅜ  안녕하세요, 수력충전 시리즈 추천드려요. 수력충전 중등 수학은 1학년 과정은 수력충전 중등 수학... "
수포자 고등수학	안녕하세요 늦게나마 수학 시작해보려고하는데 중등수학부터는 아예 백지상태입니다 이제 고1 들어가는데 고 1수학... 인강 + 학원 or 인강 + 개인과외병행하는게좋아요. 실력을 올리는데 효과적인 순서는 1:1 개인과외 > 학원 > 인강... 
수학 공부방법(벼락치기)	... 남은 열흘동안 정말 수학을 가장 효율적으로 빠르게 성적을 올릴 수 있는 방법 좀 알려주세요 하루에 몇시간씩 할수도 있고 문제집 추천도 좋아요  수학은 단기간에 성적을 올릴 수 있는 과목이 아닙니다. 하지만 10일 남은 상황에서... 
중 1-1 수학 4문제만 풀어주세요 식은 간단해도 좋아요	제발 도와주세요ㅠㅜㅠㅠㅜㅜ 진짜 도와주시는분 천사 ㅠㅜㅠㅠ 어여 주무세요 
"수학,영어가 너무 어려워요!!"	... 숙제할때나 복습 선행할때 좋아요... 모르는 문제는 페이지 번호만 치면 풀이 영상이 바로 나옵니다. 유튜브에 엠블럭스라고 치면 수학 풀이 영상이 많이 올라와 있어요... 한번 들어보세요~ 전 학원에서 수업듣고 집에 와서 엠블럭스로... 
내손동 일대일 영어과외 수학과외 또는 소규모도 좋아요	"... 오전동수학과외 오전동영어과외를 찾는중이에요~ 현재... 오전동 또는 근처 동네 내손동수학과외 내손동영어과외... 영어 수학 학원, 단과학원, 영수 종합학원, 국어 과학... 수업 과목으로는 국어, 영어, 수학( 수리가형, 수리나형 )은... "
"고1 수학이요. 선생님 (과외,학원)들 봐주세요"	... 다좋아요 수학에 대해 모든걸 알려주세요 수학공부는 어케 하는게 좋아요?  저는 이번에 수능을 본 이과생이구요 운이 좋게 과외자리를 얻어 과외를 하고 있답니다. 음...우선은 님이 중학교 다닐때 수학공부를 소홀이 하신건... 
이과 수학 성적 낮음	"... 어쩌면 좋아요? 눈물이 나오네요 수학을 잘하고 싶어요 근데 제일 못해요 제가 뭘 하면 되는거죠 대학은 갈 수 있을까요ㅠㅠㅠㅠㅠ  ebs에 정승제쌤이 개념끝장내기 수상 수하 강의를 하는데, 첫번째 강의에서 이런 말씀을 하십니다.... "
고려대 정시 수학 보나요?	"제목 그대롭니다 ㅠㅠ 정시로 고려대 가려면 최소 등급이 어떻게 (정확할수록 좋아요!) 되는지랑 호옥시.. 수학 안 보는 학과가 있을지 궁금합니다 ㅠㅠ 안녕하세요 수학 당연히 봅니다 공부해야 돼요 새해 복 많이 받으시고,""포인트로... "
전준홍선생님 수학인강 추천 질문?	... 그리고 문풀 수학인강도 좋아요 ~~~ 문제설명도 깔끔하고 수학은 문제푸는방법이 여러가지잖아요 ~ 그래서 좀 헷갈렸던 문제들도 문풀에 나오면 한번씩 다시 보거든요 일단은 한가지 풀이법이 아니라 다른방식으로도 설명을... 
분당수학학원 중학생아이'	"... 하지만 너무 분당수학학원 명성만 따지시기보단, 어떤 시스템을 갖추고 있는지… 그 시스템이 우리 아이에게 적합할지… 그 시스템이 제대로 이뤄지고 있는지 등이것 저것 꼼꼼하게 따져보시고 분당수학학원을 고르시는 게 좋아요.... "
고2 수학 노베 뭐해야돼요?	... 여건이 된다면 아래 답변내용은 참고만 하시고 바로 학원으로 ㄱㄱ하세요 우선 빵꾸난 이전 개념들은 최대한 빠르게 훑고 지나가는게 좋아요.. 중학수학은 EBSI에서 2주면 끝이라는 강의가 개설되어 있어요. 중학수학 10강으로... 
수학여행	"... 버스 타고 가면서 할수있는 재미 있는 놀이.(버스를 타면 뒷자석이 좋아요?앞자석이 좋아요?) 3. 수학여행에가서 첫째날, 둘째날, 셋째날, 장기자랑옷, 잠옷 이렇게 가저갈껀데요 옷좀 추천을.. 4. 저희가 애버랜드를 가는데요 어떤... "
광장동 수학학원	"... (3) 수학잘가르치는 학원 3군데정도 알려주세요  구주이배, 두엔비,해강수학이요. 구주이배나두엔비는 한반에 정원이 많구요 해강수학은 소수로 합니다, 꼼꼼히 하살려면 해강수학이좋아요."
수학여행★	... 4에버랜드에서 할것 (스릴있고 재밋는 놀이기구랑 선물샵 추천해주세요) 5수학여행 코디좀..(사진있으면 더 좋아요) 6수학여행때 캐리어가 좋을까요 배낭같은게 좋을까요?? 내공냠냠등 이상한글 올리는사람은 신고 합니다... 1... 
외국식 수학 과외..	"... 만약 외국식을 모르신다면 그냥 싼 1대1 수학과외도 좋아요.. 내공만 먹는 사람은 신고합니다 나도 싱가폴에 산지 1년 반 정도가 되어가고 있는 학생이지만..... 그 수학이라는 공부가, 실제로 보면 한국이 상당히 수준이 높기 때문에... "
수학문제집 이름 좀 알려주세요!!ㅠ(표지사진이 있으면... 	중2수학문제집인데 이름이 기억안나서 질문합니다. 기억나는 특징이 있다면 일단 표지는 모레?비슷한 연갈색이고 검은색 글씨로 위에 이름이 써있는데 이 이름이 꾀 길고 특이한 이름이었어요!! 그리고 또 기억나는 특징은 이 문제집이... 
평촌 왕수학학원과 페르마 어디가 좋아요?	... 왕수학학원에서 테스트를 했는데 경시반으로 나왔으나 하루 3시간의 수업... 정말 추천합니다 왕수학은 제가 다녀봣는데 별로고 학원가에서 수학잘가르... 거기쭉 다니시면 수학 경시대회에서 상을 거의 휩쓸고 다니실껍니다. 
군산 고등1 수학?영어 학원 추천	"... 군산에서 고등1 수학?영어 학원 좋은곳으로 추천해주세요! 이번에 고1이 되는 학생인데 학원을 다니려는데 어딜... +통학되는 즉, 카플(버스)되는 학원도 좋아요! 학생의 스타일과 현재 상태를 명확히 알고 선택을 하셔야 해요.... "
이과인데 수학점수가 너무안좋아요.... 	올해 수능을 볼껀데 제 수학 점수가 정말 장난이 아니예요.;;;ㅠㅠㅠ 1학년때 사회과목보다는 과탐이 좋아서 이과를 선택했는데 그땐 수학성적도 그럭저럭 하길래 이과 선택했는데. 지금은 고2말부터 30점대가 나오고 있어요. 그 전에는... 
50일 수학	(노베이스인 예비고1 입니다)50일 수학 상 이 고1 1학기를 위한 단원이고 하 는 2학기를 위한 단원 인가요? 만약 맞다면... 인강 + 학원 or 인강 + 개인과외병행하는게좋아요. 실력을 올리는데 효과적인 순서는 1:1 개인과외 > 학원 > 인강... 
[내공검]수학여행가서 재밋게놀기	... 하면 좋아요. 수학여행이니까 다 들떠서 아무 쓰잘데기 없는말에도 웃고하거든요 ㅋㅋ ③ 그냥 기본 뭐 치약칫솔 옷 이런거 말고 놀때 쓰는 그런 도구들은 뭐가져가면 좋을까요 ?(저는 뭐 친구얼굴에다가 낙서하기 그런거 싫거든요 )... 
수학학원 가야될까요..	... 그 수학학원에서 지내다 성적이 안 올라 그만두고 그저께 새로운 곳에 갔어요 듣기엔 좋아보였지만 가자마자 샤프 잡는법을 가르쳤어요(제가 이상하게 잡지 않았음) 한 혼나면서 40분간 샤프 잡는법만 하고 노트에 풀이를... 
수학여행 경복궁	"... 몇년 전걸로 말고 현재도 진행중인거면 더 좋아요! 저도 6학년 수학여행을 경복궁으로 갔었죠. 경복궁 안 광화문 뒤쪽에는 고궁박물관이 있습니다. 가서 물시계, 옛날 유물들 구경해도 좋고요, 근정전, 경회루등등 구경도 할 수... "
문이과 선택에서 수학의 비중	... 따라서 이과를 피하시는 선택을 하기보다는 수학을 극복하는 노력을 하시는게 더 좋아보입니다. 나중에 문과로 간다고 해서 무조건 취업이 안되는 것은 아닙니다. 다만 현 시점에서는 아무래도 이공계 계열의 직업군 수요나... 
"삼양사거리 수학학원,과외 추천해주세요ㅠㅠ"	고1이고요 개념 탄탄하게 잡아주고 내신대비 확실하게 해주는 수학학원 추천해주세요ㅠㅠㅠㅠ 빡빡할수록 좋아요 결석 조퇴 잘 안시켜주고 보충 많이 부르는 그런 빡센 학원이요 삼양사거리에서 멀지 않았으면 좋겠어요 과외도 추천... 
경영학과인데 고등수학이 좋아요	스트레스 받을때 미적분2나 기벡같은 고딩때 문제집 열어서 풀고 그러는데.. 전공이랑 전혀 안맞고.. 뭔가 시간 낭비 같아요 어떻게 해야 효율적으로 느껴질까요..  ★백석문화대학교 홍보대사입니다★ 진로와 연관된 과목을 집중적으로... 
수원수학학원	"... 제가 아예 수학에 손을 놓고있다가 다니는거라서 잘가르칠수 있는 곳이면 좋겠어요 수학영어가 합쳐있는 학원도 좋아요  안녕하세요! 수학학원 찾고 계셔서 답변 남겨드려요! 지금 1대1 과외도 진행을 하고 있고, 근처에... "
★6학년수학공부★	... 어떻게 수학공부 하면 좋아요?학원을 다녀야 할까요? ※맞다!제가 응용력이 좀 부족해요.응용력 높이는 법좀알려주세요. 질문 많아서 죄송합니다.ㅜ 과외는 좀 비싸잖아요 그리고 좀 힘드니까 문제집을 사서 혼자 하는것도 좋은... 
중1 수학 공부를 시키려고 하는데 뭐가 좋아요???	"... 중1 수학 공부 질문에 답변드려요~ 수학은 기본 개념이 중요하며 기본... 수학 공부도 더 체계적이고 효율적인 학습을 할 수 있도록 도와주는... 수학은 입문- 기본- 발전- 심화 과정을 통해 왕초보 수학 입문자부터, 내신 만점의 수학... "
수학여행♡ 코디	... 우선기본적인거하고 패션아이템이나 소품같은것도 좋아요 2.수학여행때 입고갈옷 첫째날: 둘째날: 셋째날: 이렇게 알려주세요 이미지 참고하시면 더욱 좋아요 ^_^ 3.수학여행에서 밤에 놀때 머하고 놀지요 ? 배게싸움이나 진실게임... 
반포수학학원 추천해주세요	... 하는게 좋아요 그런데 이런 쌤 찾는게 더 힘들어요 ㅠㅠ 저는 그래도 꾸준히 관찰해주는 편이라고 생각하는데 부모님이 조금만 한눈 팔아도 귀신같이 알아채고 관리 확 푸는 반포수학학원들 너무 많아가지고 ㅠㅠ 솔직히 너무... 
분당수학학원 광고절대사절	"... 안녕하세요 분당수학학원 여쭤보셔서 도움될까 싶어 답변드려봐요~ 공부 습관이 제대로 잡혀있지 않는 아이라면, 관리가 조금 깐깐한 분당수학학원을 보내시는 게 좋아요. 저희 애는 특히 수학을 어렵고 힘들어해서 자율적인... "
수학만 잘하고 내신이 너무안좋아 ㅠㅠ	... 수학은 꾸준한 노력히 필요해서 기초부터 잡아야 점수가 오를 수 있는 과목 이라고 하잖아요..님이 수학을 좋아하고 수학선생님이 되고싶다고 수학을 열심히 노력해서 점수가 잘 나오는거 아닐까요?? 암기과목은 거의 다 암기해야 하... 
제가 수학의정석을 풀수있을까요?	... 수학을 중3때좋아하기시작했었습니다..(하지만 수학 하위권)... 진짜 지금도 수학이 하위권이고요.. 하지만 제가 학원을다니는데. 학원쌤이 개념은 아는데 유형문제를 잘못푼다고 하더라고요. 하지만 저는 수학의 정석 이 풀고싶은데... 
수학여행 갈때 ;; (내공25)	... 수학여행가면 숙소 좋아요? 4. 전라도로 가는데 날씨는 어떤가요? (10월 8일~10월 10일 ) 5. 교관 무섭나요 ;; 6. 갈때 준비물좀 알려주세요 =ㅂ= << 혹시나 뭐 하나 빼먹고 갈까봐 헤헿 그럼 부탁드립니다 선배님들(응?) 앗 글구 수학여행... 
"학점은행제, 토익, 수학, 물리/천문 관련 책 찾아요.... "	"... 수학은 초등 수학부터 고등수학 심화까지 공식 원리 설명이 친절하게 적혀있는 서적 추천 5. 물리학에 관련된 기초적인 서적(상식도 좋고, 4번처럼 공식 원리 설명 다 써져있음 좋아요.) 6. 우주과학, 천문학에 관련된 서적(이쪽도 다른... "
중1 수학 공부를 시키려고 하는데 뭐가 좋아요???	"... 그 외에도 수학은 수학전문코너에서 심화학습 가능한 강좌가 제공되며 영어의 경우 문법, 어휘, 독해등 분야별 학습이 가능합니다. 무한수강을 신청할 시 담임선생님의 학습 관리가 진행되며, 알파온서비스 신청 시... "
대치동 수학학원	안녕하세요 저는 중대부고 3학년입니다 작년까진 모평보면 일등급나왔는데 이번 모평 수리 이등급나왔어요 우울모드 ㅜㅜ 인강만으론 무리가 있는듯 대치동 수학학원 어디가 좋아요? 아 이과구요 수학성적잘오르는 대치동 수학학원... 
수학여행때할 장기자랑 춤4~5명(신나는건 더좋아요... 	5월30날 수학여행으로 여수액스포를 가요 장기자랑으로 춤을하려고하는데요 명수는4~6명사이면 좋아요(뇨자이구요) 신나는것은더! 좋구요 인기많은것도좋아요 마니마니 추천좀해주세요!! 머리 숙여 부탁드립니다. 내공 25드립니다.!!... 
중 2수학문제집 추천해주세요	... 개념원리로 개념익힌후 황제수학의 문제를 풀면 좋아요^^ 황제수학 문제 잘은 몰라도.. 일학년 이학기때 127유형의 1173문제가 수록됐다고 하니.. 이번에도 비슷하겠죵?? 그럼 공부 열심히 하세요^^
"분당수학학원 알아보는중,"	"... 다시 분당수학학원 찾아보는 것도 일이구요…ㅎㅎ 다른 분당수학학원으로 옮겨야 할 상황이 안 생기도록, 처음부터 제대로 된 분당수학학원을 찾으시는 게 좋아요. 제 경험담입니다ㅎㅎ 더원이랑 가인아카데미, 두 분당수학학원에... "
수학여행 장기자랑이여>.<	"... 저까지 4명이구요 저랑 친구 A는 키작구요 친구 B,C는 키크구요 다 얼굴이 되는편은 아니구요ㅜㅜ 머 춤출만한거 없을까요?노래나 춤 다 좋아요 그리구 수학여행 코디나 준비물좀 아르켜주세요ㅜㅜ 부탁드립니다!!! 안녕하세요... "
초등학교5학년 수학잘하는법	... 나름 좋아요.. 수학 문제집은 전.. 해법 쓰구요... 이거 말구 다른거 원하신다면.. 수학은.. 쎈 수학?? 그거 쓰세요.. 그건 문제가 어려워서.. 문제 나오면 쉽게 잘 풀거에요.. 전 교학사 위주로 쓰니까.. 국수사과 문제집 해법 써요..... 
대치동 수학학원 추천 중3	... 좋은답변 부탁드릴게요 좋은하루되세요:}  함영원 수학학원 이승지쌤반 좋아요 우리 애가 몇년전에 배웠던 쌤인데 지금 거기 계신다고 하더라구요 한반 정원도 그렇게 많지않고 꼼꼼하고 잘 가르쳐 주실거에요 우리애는 지금 고3인데... 
고1 수학 문제집	... 하지만 외국으로 유학을 가면 교육과정이 달라서 그 나라 교육과정에 맞춰서 공부하시는게 좋아요. 우리나라 수학보단 그 나라 수학 커리큘럼에 맞춰서 공부하세요. 혹은 미국수학이나 유학가는 나라에 수학 수업이 가능한... 
중3 수학좀요 ㅠㅠ	"... 개념이 많이 나와있는 문제집과 문제가 많은(너무 많은건 안 좋아요! 수학에 질릴수 있어요) 문제집 두권을 잡고, 교과서 없어도 되니깐... 개념을 잡으면서 풀면, 얼추 개념이 잡힐 거예요~ 어느 학년이라고 할 것 없이 중1~3년 과정을... "
수학여행 장기자랑이여>.<	"... 저까지 4명이구요 저랑 친구 A는 키작구요 친구 B,C는 키크구요 다 얼굴이 되는편은 아니구요ㅜㅜ 머 춤출만한거 없을까요?노래나 춤 다 좋아요 그리구 수학여행 코디나 준비물좀 아르켜주세요ㅜㅜ 부탁드립니다!!!  저는 얼마 전에... "
중3 고등수학 선행질문	"... 고등수학 문제집 추천해주세요!(처음하고, 혼자하는 공부하는거니까 쉽고, 개념이 잘 나와있는 문제집으로 부탁드려요. 여러권도 좋아요!) 2. 지금부터 열심히 하면 저 친구들 따라 잡을수 있을까요? 3. 인강을 듣는게 좋을까요? 1.... "
공통수학에 대헤서 질문~~	... 정석은 혼자 공부하기도 좋구요 설명도 잘되 있구요 ^^ 정석이 따분해서 하기 싫으시면 수학의 바이블도 좋아요 ^^ 수학의 바이블은 정석과 달리 재미있습니다 그런데 어찌보면 조금 어지럽다[?] 라고도 할수 있어요 님께서 말씀하신... 
수학인강 + 수학 공부법	"... 알다시피 수학은 연계의 학문인 만큼 개념의 연결고리를 선수학습 체계로 시스템적으로 연결해 놓은 수학인강이 좋아요. 그리고 그 강의는 수1,수2, 기벡, 확통 등 따로 수강 하는 것이 아니라 한방에 들을 수 있게 해주는 곳이... "
재미있는 수학상식 몇가지 소개점 해주세요..^^	많아도 좋고 적어도 좋아용.... 수학신문에 써야되는데 적절히 괜찮은 내용 좀 올려주세요%^^ 수학에 대한 이야기중 재미있는것을 꼽으라면 단연 파라독스가 되겠죠. 대표적인 파라독스로는 헤라클레스와 거북이가 있습니다... 이... 
중1 수학 문제집 어떤게 좋아요?	"이번에 중1 올라가는데요 수학 문제집 좋은 것 좀 추천해주세요 난이도 ★★☆☆☆ 정도..^^; 그리고 좋은 영어... 소개 좀 부탁드립니다 ^-^  수학문제집으로는 처음에 교과서랑 같이 공부하실땐 개념원리를 많이 쓰시구요, 같이 할 때... "
수학 잘하는법좀..	... 내일보단 빠릅니다. 더럽게 마음에 와 닿은 ㅎㅎ 저도 중딩때는 꼴통 이었는데요 ㅎㅎ 수학을 제일 먼저 하세요 다른 과목 보다 싫어도 수학을 먼저 하세요 ^^* 좋아 하는것만 하다보면... 나중에 낭패 봅니다 ㅎ 
수학여행은 어떤여행인가요? 또 어디가 좋아요?	"... 좀 자세하게 알려주시면 감사하겠습니다. 또 장소는 어디가 좋아요? 외국이라든지 이런 어처구니 없는 말말고 확실히 추천좀 부탁드려요 내공냠냠등은 사절입니다.  수학여행가면,,,유적지나,,무슨 생지랄을 하고다닙니다...ㅋ"
수학 문제집	"고등학교 수학 문제집 rpm, 수력충전, 쎈, 체크체크 중에 뭐가 좋아요???  수학 개념서로는 개념원리, 바이블, 개념쎈 많이 사용합니다. 그리고 문제 풀이 용으로는 알피엠이랑 라이트쎈, 쎈, 자이스토리, 마플 많이들 사용하구요. 그 다음... "
